ACCT_NO,TRANSACTION DETAILS,CHQ.NO.,VALUE DATE,WITHDRAWAL AMT,DEPOSIT AMT,BALANCE AMT,Merchant,Platform,Category
409032131114131312,TRF FROM  Indiaforensic SERVICES,,29-Jun-17,,1000000,1000000,,,
409000611074',TRF FROM  Indiaforensic SERVICES,,5-Jul-17,,1000000,2000000,,,
409000611074',FDRL/INTERNAL FUND TRANSFE,,18-Jul-17,,500000,2500000,,,
409000611074',TRF FRM  Indiaforensic SERVICES,,1-Aug-17,,3000000,5500000,,,
409000611074',FDRL/INTERNAL FUND TRANSFE,,16-Aug-17,,500000,6000000,,,
409000611074',FDRL/INTERNAL FUND TRANSFE,,16-Aug-17,,500000,6500000,,,
409000611074',FDRL/INTERNAL FUND TRANSFE,,16-Aug-17,,500000,7000000,,,
409000611074',FDRL/INTERNAL FUND TRANSFE,,16-Aug-17,,500000,7500000,,,
409000611074',FDRL/INTERNAL FUND TRANSFE,,16-Aug-17,,500000,8000000,,,
409000611074',FDRL/INTERNAL FUND TRANSFE,,16-Aug-17,,500000,8500000,,,
409000611074',INDO GIBL Indiaforensic STL01071,,16-Aug-17,133900,,8366100,pvr,hdfc_bank,travel
409000611074',INDO GIBL Indiaforensic STL02071,,16-Aug-17,18000,,8348100,ola,paytm,mutual_fund
409000611074',INDO GIBL Indiaforensic STL03071,,16-Aug-17,5000,,8343100,cred,gpay,girl_friend
409000611074',INDO GIBL Indiaforensic STL04071,,16-Aug-17,195800,,8147300,bigboss,amazon_pay,mutual_fund
409000611074',INDO GIBL Indiaforensic STL05071,,16-Aug-17,81600,,8065700,groffers,phonepe,jewellary
409000611074',INDO GIBL Indiaforensic STL06071,,16-Aug-17,41800,,8023900,bigboss,bhim,mutual_fund
409000611074',INDO GIBL Indiaforensic STL07071,,16-Aug-17,98500,,7925400,reliance,paytm,jewellary
409000611074',INDO GIBL Indiaforensic STL10071,,16-Aug-17,143800,,7781600,groffers,paytm,girl_friend
409000611074',INDO GIBL Indiaforensic STL11071,,16-Aug-17,331650,,7449950,lenscart,gpay,girl_friend
409000611074',INDO GIBL Indiaforensic STL12071,,16-Aug-17,129000,,7320950,groffers,gpay,withdrawal
409000611074',INDO GIBL Indiaforensic STL13071,,16-Aug-17,230013,,7090937,zomato,paytm,grocery
409000611074',INDO GIBL Indiaforensic STL14071,,16-Aug-17,367900,,6723037,swiggy,gpay,girl_friend
409000611074',INDO GIBL Indiaforensic STL15071,,16-Aug-17,108000,,6615037,mba_chai,bharatpe,wallet
409000611074',INDO GIBL Indiaforensic STL16071,,16-Aug-17,64800,,6550237,mba_chai,amazon_pay,travel
409000611074',INDO GIBL Indiaforensic STL17071,,16-Aug-17,141000,,6409237,pvr,amazon_pay,grocery
409000611074',INDO GIBL Indiaforensic STL18071,,16-Aug-17,61750,,6347487,groffers,zeppay,withdrawal
409000611074',INDO GIBL Indiaforensic STL19071,,16-Aug-17,67920,,6279567,cred,mobikwik,bill_payments
409000611074',INDO GIBL Indiaforensic STL20071,,16-Aug-17,78100,,6201467,zomato,mobikwik,shopings
409000611074',INDO GIBL Indiaforensic STL21071,,16-Aug-17,35650,,6165817,zomato,hdfc_bank,mutual_fund
409000611074',INDO GIBL Indiaforensic STL22071,,16-Aug-17,206000,,5959817,mba_chai,phonepe,bill_payments
409000611074',INDO GIBL Indiaforensic STL24071,,16-Aug-17,35300,,5924517,groffers,gpay,shopings
409000611074',INDO GIBL Indiaforensic STL25071,,16-Aug-17,49800,,5874717,reliance,zeppay,mutual_fund
409000611074',INDO GIBL Indiaforensic STL26071,,16-Aug-17,53000,,5821717,uber,paytm,grocery
409000611074',INDO GIBL Indiaforensic STL27071,,16-Aug-17,91300,,5730417,ola,bhim,bill_payments
409000611074',INDO GIBL Indiaforensic STL28071,,16-Aug-17,57499,,5672918,cred,phonepe,insurance
409000611074',INDO GIBL Indiaforensic STL30071,,16-Aug-17,20000,,5652918,pentaloon,bhim,shopings
409000611074',INDO GIBL Indiaforensic STL31071,,16-Aug-17,19400,,5633518,pentaloon,mobikwik,bill_payments
409000611074',INDO GIBL Indiaforensic STL01081,,6-Sep-17,40500,,5593018,pentaloon,hdfc_bank,bill_payments
409000611074',INDO GIBL Indiaforensic STL02081,,6-Sep-17,242300,,5350718,mba_chai,paytm,jewellary
409000611074',INDO GIBL Indiaforensic STL03081,,6-Sep-17,90100,,5260618,uber,phonepe,bill_payments
409000611074',INDO GIBL Indiaforensic STL04081,,6-Sep-17,113250,,5147368,mba_chai,gpay,jewellary
409000611074',INDO GIBL Indiaforensic STL05081,,6-Sep-17,12500,,5134868,swiggy,bhim,girl_friend
409000611074',INDO GIBL Indiaforensic STL06081,,6-Sep-17,40000,,5094868,pentaloon,mobikwik,bill_payments
409000611074',INDO GIBL Indiaforensic STL07081,,6-Sep-17,206900,,4887968,mba_chai,phonepe,withdrawal
409000611074',INDO GIBL Indiaforensic STL08081,,6-Sep-17,276000,,4611968,reliance,bharatpe,withdrawal
409000611074',INDO GIBL Indiaforensic STL09081,,6-Sep-17,171000,,4440968,uber,paytm,mutual_fund
409000611074',INDO GIBL Indiaforensic STL10081,,6-Sep-17,40100,,4400868,uber,paytm,girl_friend
409000611074',INDO GIBL Indiaforensic STL11081,,6-Sep-17,189800,,4211068,zomato,bharatpe,grocery
409000611074',INDO GIBL Indiaforensic STL12081,,6-Sep-17,55800,,4155268,zomato,paytm,insurance
409000611074',INDO GIBL Indiaforensic STL13081,,6-Sep-17,95400,,4059868,zomato,gpay,bill_payments
409000611074',INDO GIBL Indiaforensic STL14081,,6-Sep-17,271323,,3788545,ola,bhim,bill_payments
409000611074',INDO GIBL Indiaforensic STL16081,,6-Sep-17,200600,,3587945,bigboss,paytm,insurance
409000611074',INDO GIBL Indiaforensic STL17081,,6-Sep-17,176900,,3411045,reliance,paytm,mutual_fund
409000611074',INDO GIBL Indiaforensic STL18081,,6-Sep-17,150050,,3260995,reliance,paytm,bill_payments
409000611074',INDO GIBL Indiaforensic STL19081,,6-Sep-17,82500,,3178495,uber,paytm,girl_friend
409000611074',INDO GIBL Indiaforensic STL20081,,6-Sep-17,14800,,3163695,zomato,gpay,withdrawal
409000611074',INDO GIBL Indiaforensic STL21081,,6-Sep-17,150600,,3013095,cred,zeppay,jewellary
409000611074',INDO GIBL Indiaforensic STL22081,,6-Sep-17,203325,,2809770,swiggy,mobikwik,mutual_fund
409000611074',INDO GIBL Indiaforensic STL23081,,6-Sep-17,123900,,2685870,bigboss,bhim,mutual_fund
409000611074',INDO GIBL Indiaforensic STL24081,,6-Sep-17,33863,,2652007,reliance,paytm,wallet
409000611074',INDO GIBL Indiaforensic STL25081,,6-Sep-17,32000,,2620007,uber,hdfc_bank,grocery
409000611074',INDO GIBL Indiaforensic STL26081,,6-Sep-17,8299,,2611708,groffers,zeppay,grocery
409000611074',INDO GIBL Indiaforensic STL28081,,6-Sep-17,52219,,2559489,mba_chai,bharatpe,jewellary
409000611074',INDO GIBL Indiaforensic STL29081,,6-Sep-17,96450,,2463039,pentaloon,phonepe,wallet
409000611074',INDO GIBL Indiaforensic STL30081,,6-Sep-17,139863,,2323176,bigboss,paytm,wallet
409000611074',INDO GIBL Indiaforensic STL31081,,6-Sep-17,52723,,2270453,reliance,gpay,travel
409000611074',INDO GIBL Indiaforensic STL01091,,25-Sep-17,77251,,2193202,cred,phonepe,wallet
409000611074',INDO GIBL Indiaforensic STL02091,,25-Sep-17,20000,,2173202,pentaloon,hdfc_bank,bill_payments
409000611074',INDO GIBL Indiaforensic STL03091,,25-Sep-17,10000,,2163202,zomato,amazon_pay,shopings
409000611074',INDO GIBL Indiaforensic STL04091,,25-Sep-17,103600,,2059602,zomato,bhim,jewellary
409000611074',INDO GIBL Indiaforensic STL05091,,25-Sep-17,71000,,1988602,bigboss,gpay,travel
409000611074',INDO GIBL Indiaforensic STL06091,,25-Sep-17,129400,,1859202,lenscart,bhim,girl_friend
409000611074',INDO GIBL Indiaforensic STL07091,,25-Sep-17,290163,,1569039,uber,phonepe,bill_payments
409000611074',INDO GIBL Indiaforensic STL08091,,25-Sep-17,34300,,1534739,ola,bhim,wallet
409000611074',INDO GIBL Indiaforensic STL09091,,25-Sep-17,49800,,1484939,reliance,bhim,travel
409000611074',INDO GIBL Indiaforensic STL10091,,25-Sep-17,44800,,1440139,pentaloon,phonepe,jewellary
409000611074',INDO GIBL Indiaforensic STL11091,,25-Sep-17,151550,,1288589,cred,mobikwik,grocery
409000611074',INDO GIBL Indiaforensic STL12091,,25-Sep-17,310399,,978190,zomato,bhim,jewellary
409000611074',INDO GIBL Indiaforensic STL13091,,25-Sep-17,271401,,706789,pentaloon,gpay,mutual_fund
409000611074',INDO GIBL Indiaforensic STL14091,,25-Sep-17,275449,,431340,bigboss,amazon_pay,jewellary
409000611074',INDO GIBL Indiaforensic STL15091,,25-Sep-17,51502,,379838,pvr,gpay,bill_payments
409000611074',INDO GIBL Indiaforensic STL16091,,25-Sep-17,36650,,343188,ola,gpay,travel
409000611074',INDO GIBL Indiaforensic STL17091,,25-Sep-17,99600,,243588,swiggy,gpay,insurance
409000611074',FDRL/INTERNAL FUND TRANSFE,,25-Sep-17,,500000,743588,,,
409000611074',FDRL/INTERNAL FUND TRANSFE,,25-Sep-17,,500000,1243588,,,
409000611074',FDRL/INTERNAL FUND TRANSFE,,25-Sep-17,,500000,1743588,,,
409000611074',FDRL/INTERNAL FUND TRANSFE,,25-Sep-17,,500000,2243588,,,
409000611074',FDRL/INTERNAL FUND TRANSFE,,25-Sep-17,,500000,2743588,,,
409000611074',INDO GIBL Indiaforensic STL18091,,26-Sep-17,411763,,2331825,swiggy,bhim,shopings
409000611074',INDO GIBL Indiaforensic STL19091,,26-Sep-17,355138,,1976687,swiggy,bhim,jewellary
409000611074',INDO GIBL Indiaforensic STL20091,,26-Sep-17,88656,,1888031,uber,mobikwik,withdrawal
409000611074',INDO GIBL Indiaforensic STL21091,,26-Sep-17,14800,,1873231,groffers,zeppay,travel
409000611074',INDO GIBL Indiaforensic STL22091,,26-Sep-17,27000,,1846231,reliance,amazon_pay,bill_payments
409000611074',INDO GIBL Indiaforensic STL23091,,26-Sep-17,42850,,1803381,groffers,mobikwik,girl_friend
409000611074',INDO GIBL Indiaforensic STL24091,,26-Sep-17,39925,,1763456,lenscart,gpay,shopings
409000611074',INDO GIBL Indiaforensic STL25091,,26-Sep-17,202106,,1561350,swiggy,phonepe,withdrawal
409000611074',INDO GIBL Indiaforensic STL26091,,27-Sep-17,169802,,1391548,cred,mobikwik,withdrawal
409000611074',INDO GIBL Indiaforensic STL27091,,28-Sep-17,200570,,1190978,pentaloon,bharatpe,travel
409000611074',INDO GIBL Indiaforensic STL28091,,3-Oct-17,12106,,1178872,lenscart,bharatpe,jewellary
409000611074',INDO GIBL Indiaforensic STL29091,,3-Oct-17,12611,,1166261,reliance,amazon_pay,withdrawal
409000611074',INDO GIBL Indiaforensic STL30091,,3-Oct-17,9375,,1156886,ola,bhim,jewellary
409000611074',INDO GIBL Indiaforensic STL03101,,4-Oct-17,125200,,1031686,uber,mobikwik,mutual_fund
409000611074',INDO GIBL Indiaforensic STL04101,,5-Oct-17,61400,,970286,bigboss,gpay,girl_friend
409000611074',INDO GIBL Indiaforensic STL05101,,6-Oct-17,143700,,826586,pvr,bhim,insurance
409000611074',FDRL/INTERNAL FUND TRANSFE,,16-Oct-17,,500000,1326586,,,
409000611074',FDRL/INTERNAL FUND TRANSFE,,16-Oct-17,,500000,1826586,,,
409000611074',FDRL/INTERNAL FUND TRANSFE,,16-Oct-17,,500000,2326586,,,
409000611074',INDO GIBL Indiaforensic STL06101,,17-Oct-17,6000,,2320586,uber,gpay,grocery
409000611074',INDO GIBL Indiaforensic STL07101,,17-Oct-17,97950,,2222636,uber,phonepe,insurance
409000611074',INDO GIBL Indiaforensic STL08101,,17-Oct-17,33000,,2189636,groffers,mobikwik,girl_friend
409000611074',INDO GIBL Indiaforensic STL09101,,17-Oct-17,329300,,1860336,ola,paytm,girl_friend
409000611074',INDO GIBL Indiaforensic STL10101,,17-Oct-17,18000,,1842336,swiggy,bhim,jewellary
409000611074',INDO GIBL Indiaforensic STL11101,,17-Oct-17,113400,,1728936,groffers,mobikwik,wallet
409000611074',INDO GIBL Indiaforensic STL12101,,17-Oct-17,262226,,1466710,mba_chai,zeppay,mutual_fund
409000611074',INDO GIBL Indiaforensic STL13101,,17-Oct-17,318750,,1147960,cred,amazon_pay,jewellary
409000611074',INDO GIBL Indiaforensic STL14101,,17-Oct-17,65549,,1082411,cred,hdfc_bank,shopings
409000611074',INDO GIBL Indiaforensic STL17101,,18-Oct-17,206501,,875910,mba_chai,bhim,wallet
409000611074',FDRL/INTERNAL FUND TRANSFE,,21-Oct-17,,500000,1375910,,,
409000611074',INDO GIBL Indiaforensic STL18101,,21-Oct-17,85000,,1290910,zomato,amazon_pay,insurance
409000611074',INDO GIBL Indiaforensic STL19101,,21-Oct-17,76389,,1214521,uber,zeppay,mutual_fund
409000611074',INDO GIBL Indiaforensic STL20101,,21-Oct-17,62725,,1151796,zomato,bhim,wallet
409000611074',INDO GIBL Indiaforensic STL21101,,23-Oct-17,39000,,1112796,swiggy,bharatpe,bill_payments
409000611074',INDO GIBL Indiaforensic STL22101,,23-Oct-17,9600,,1103196,mba_chai,amazon_pay,withdrawal
409000611074',INDO GIBL Indiaforensic STL23101,,24-Oct-17,123260,,979936,pentaloon,paytm,jewellary
409000611074',INDO GIBL Indiaforensic STL24101,,25-Oct-17,369803,,610133,mba_chai,paytm,girl_friend
409000611074',INDO GIBL Indiaforensic STL25101,,26-Oct-17,170125,,440008,pvr,phonepe,mutual_fund
409000611074',FDRL/INTERNAL FUND TRANSFE,,26-Oct-17,,500000,940008,,,
409000611074',INDO GIBL Indiaforensic STL26101,,27-Oct-17,208000,,732008,bigboss,amazon_pay,insurance
409000611074',FDRL/INTERNAL FUND TRANSFE,,30-Oct-17,,500000,1232008,,,
409000611074',INDO GIBL Indiaforensic STL27101,,30-Oct-17,291150,,940858,groffers,mobikwik,insurance
409000611074',INDO GIBL Indiaforensic STL28101,,30-Oct-17,24000,,916858,pentaloon,bhim,insurance
409000611074',INDO GIBL Indiaforensic STL30101,,31-Oct-17,141546,,775312,groffers,zeppay,insurance
409000611074',INDO GIBL Indiaforensic STL31101,,1-Nov-17,80000,,695312,swiggy,gpay,shopings
409000611074',INDO GIBL Indiaforensic STL01111,,2-Nov-17,46250,,649062,cred,paytm,travel
409000611074',INDO GIBL Indiaforensic STL02111,,3-Nov-17,42825,,606237,uber,bhim,girl_friend
409000611074',INDO GIBL Indiaforensic STL03111,,6-Nov-17,179463,,426774,ola,zeppay,wallet
409000611074',INDO GIBL Indiaforensic STL04111,,6-Nov-17,18949,,407825,uber,bharatpe,grocery
409000611074',INDO GIBL Indiaforensic STL05111,,6-Nov-17,91441,,316384,lenscart,hdfc_bank,jewellary
409000611074',INDO GIBL Indiaforensic STL06111,,7-Nov-17,147750,,168634,reliance,mobikwik,insurance
409000611074',FDRL/INTERNAL FUND TRANSFE,,8-Nov-17,,500000,668634,,,
409000611074',FDRL/INTERNAL FUND TRANSFE,,8-Nov-17,,500000,1168634,,,
409000611074',INDO GIBL Indiaforensic STL07111,,8-Nov-17,110188,,1058446,zomato,phonepe,wallet
409000611074',INDO GIBL Indiaforensic STL08111,,9-Nov-17,61870,,996576,swiggy,bharatpe,girl_friend
409000611074',INDO GIBL Indiaforensic STL09111,,10-Nov-17,84101,,912475,pvr,amazon_pay,wallet
409000611074',INDO GIBL Indiaforensic STL10111,,14-Nov-17,129700,,782775,groffers,paytm,wallet
409000611074',INDO GIBL Indiaforensic STL11111,,14-Nov-17,7499,,775276,bigboss,hdfc_bank,insurance
409000611074',INDO GIBL Indiaforensic STL12111,,14-Nov-17,80100,,695176,pentaloon,gpay,withdrawal
409000611074',INDO GIBL Indiaforensic STL13111,,14-Nov-17,143850,,551326,ola,zeppay,travel
409000611074',INDO GIBL Indiaforensic STL14111,,15-Nov-17,289500,,261826,reliance,amazon_pay,shopings
409000611074',FDRL/INTERNAL FUND TRANSFE,,17-Nov-17,,500000,761826,,,
409000611074',FDRL/INTERNAL FUND TRANSFE,,17-Nov-17,,500000,1261826,,,
409000611074',INDO GIBL Indiaforensic STL16111,,17-Nov-17,94900,,1166926,lenscart,phonepe,jewellary
409000611074',INDO GIBL Indiaforensic STL15111,,17-Nov-17,224851,,942075,pvr,hdfc_bank,shopings
409000611074',INDO GIBL Indiaforensic STL17111,,18-Nov-17,284953,,657122,reliance,mobikwik,bill_payments
409000611074',INDO GIBL Indiaforensic STL18111,,20-Nov-17,115150,,541972,pvr,bhim,jewellary
409000611074',INDO GIBL Indiaforensic STL19111,,20-Nov-17,40000,,501972,ola,bhim,jewellary
409000611074',FDRL/INTERNAL FUND TRANSFE,,21-Nov-17,,500000,1001972,,,
409000611074',INDO GIBL Indiaforensic STL20111,,21-Nov-17,145900,,856072,reliance,hdfc_bank,wallet
409000611074',INDO GIBL Indiaforensic STL21111,,22-Nov-17,83251,,772821,mba_chai,gpay,mutual_fund
409000611074',INDO GIBL Indiaforensic STL22111,,23-Nov-17,192200,,580621,lenscart,mobikwik,wallet
409000611074',INDO GIBL Indiaforensic STL23111,,24-Nov-17,74799,,505822,bigboss,mobikwik,shopings
409000611074',FDRL/INTERNAL FUND TRANSFE,,27-Nov-17,,500000,1005822,,,
409000611074',INDO GIBL Indiaforensic STL24117,,27-Nov-17,19400,,986422,uber,bharatpe,bill_payments
409000611074',INDO GIBL Indiaforensic STL25117,,27-Nov-17,39700,,946722,pentaloon,hdfc_bank,grocery
409000611074',INDO GIBL Indiaforensic STL26117,,27-Nov-17,42800,,903922,lenscart,gpay,shopings
409000611074',INDO GIBL Indiaforensic STL27111,,28-Nov-17,100402,,803520,swiggy,phonepe,shopings
409000611074',INDO GIBL Indiaforensic STL28111,,29-Nov-17,101500,,702020,mba_chai,mobikwik,mutual_fund
409000611074',INDO GIBL Indiaforensic STL29111,,30-Nov-17,36961,,665059,groffers,phonepe,shopings
409000611074',INDO GIBL Indiaforensic STL30111,,2-Dec-17,67850,,597209,bigboss,amazon_pay,grocery
409000611074',INDO GIBL Indiaforensic STL01121,,2-Dec-17,19800,,577409,cred,mobikwik,girl_friend
409000611074',INDO GIBL Indiaforensic STL02121,,4-Dec-17,10000,,567409,lenscart,hdfc_bank,travel
409000611074',INDO GIBL Indiaforensic STL03121,,4-Dec-17,24500,,542909,bigboss,bharatpe,shopings
409000611074',INDO GIBL Indiaforensic STL04121,,5-Dec-17,41700,,501209,reliance,amazon_pay,travel
409000611074',FDRL/INTERNAL FUND TRANSFE,,6-Dec-17,,500000,1001209,,,
409000611074',INDO GIBL Indiaforensic STL05121,,6-Dec-17,218050,,783159,mba_chai,zeppay,withdrawal
409000611074',INDO GIBL Indiaforensic STL06121,,7-Dec-17,186400,,596759,zomato,bharatpe,jewellary
409000611074',INDO GIBL Indiaforensic STL07121,,8-Dec-17,171330,,425429,lenscart,paytm,shopings
409000611074',INDO GIBL Indiaforensic STL08121,,11-Dec-17,34400,,391029,mba_chai,phonepe,wallet
409000611074',INDO GIBL Indiaforensic STL09121,,11-Dec-17,51199,,339830,mba_chai,bhim,grocery
409000611074',INDO GIBL Indiaforensic STL10121,,11-Dec-17,159150,,180680,groffers,hdfc_bank,bill_payments
409000611074',FDRL/INTERNAL FUND TRANSFE,,12-Dec-17,,500000,680680,,,
409000611074',FDRL/INTERNAL FUND TRANSFE,,12-Dec-17,,500000,1180680,,,
409000611074',INDO GIBL Indiaforensic STL11121,,13-Dec-17,206075,,974605,pentaloon,amazon_pay,travel
409000611074',INDO GIBL Indiaforensic STL12121,,13-Dec-17,142000,,832605,reliance,paytm,wallet
409000611074',INDO GIBL Indiaforensic STL13121,,14-Dec-17,350350,,482255,swiggy,mobikwik,grocery
409000611074',INDO GIBL Indiaforensic STL14121,,15-Dec-17,343900,,138355,swiggy,mobikwik,girl_friend
409000611074',FDRL/INTERNAL FUND TRANSFE,,18-Dec-17,,500000,638355,,,
409000611074',FDRL/INTERNAL FUND TRANSFE,,18-Dec-17,,500000,1138355,,,
409000611074',INDO GIBL Indiaforensic STL15121,,18-Dec-17,210500,,927855,uber,zeppay,shopings
409000611074',INDO GIBL Indiaforensic STL17121,,18-Dec-17,139500,,788355,bigboss,bhim,shopings
409000611074',INDO GIBL Indiaforensic STL16121,,18-Dec-17,92550,,695805,pentaloon,amazon_pay,wallet
409000611074',FDRL/INTERNAL FUND TRANSFE,,19-Dec-17,,500000,1195805,,,
409000611074',FDRL/INTERNAL FUND TRANSFE,,19-Dec-17,,500000,1695805,,,
409000611074',INDO GIBL Indiaforensic STL18121,,19-Dec-17,654498,,1041307,ola,mobikwik,shopings
409000611074',INDO GIBL Indiaforensic STL19121,,20-Dec-17,504450,,536857,ola,bhim,girl_friend
409000611074',FDRL/INTERNAL FUND TRANSFE,,20-Dec-17,,500000,1036857,,,
409000611074',INDO GIBL Indiaforensic STL20121,,21-Dec-17,561225,,475632,mba_chai,phonepe,bill_payments
409000611074',FDRL/INTERNAL FUND TRANSFE,,21-Dec-17,,500000,975632,,,
409000611074',FDRL/INTERNAL FUND TRANSFE,,21-Dec-17,,500000,1475632,,,
409000611074',INDO GIBL Indiaforensic STL21121,,22-Dec-17,146050,,1329582,swiggy,bhim,insurance
409000611074',INDO GIBL Indiaforensic STL22121,,26-Dec-17,100300,,1229282,ola,zeppay,girl_friend
409000611074',INDO GIBL Indiaforensic STL23121,,26-Dec-17,62425,,1166857,swiggy,amazon_pay,girl_friend
409000611074',INDO GIBL Indiaforensic STL24121,,26-Dec-17,365300,,801557,mba_chai,phonepe,jewellary
409000611074',INDO GIBL Indiaforensic STL25121,,26-Dec-17,23550,,778007,bigboss,phonepe,travel
409000611074',FDRL/INTERNAL FUND TRANSFE,,27-Dec-17,,500000,1278007,,,
409000611074',INDO GIBL Indiaforensic STL26121,,27-Dec-17,259525,,1018482,reliance,zeppay,insurance
409000611074',INDO GIBL Indiaforensic STL27121,,28-Dec-17,383110,,635372,uber,mobikwik,travel
409000611074',INDO GIBL Indiaforensic STL28121,,29-Dec-17,138150,,497222,uber,gpay,bill_payments
409000611074',FDRL/INTERNAL FUND TRANSFE,,29-Dec-17,,500000,997222,,,
409000611074',INDO GIBL Indiaforensic STL29121,,30-Dec-17,285399,,711823,groffers,amazon_pay,jewellary
409000611074',INDO GIBL Indiaforensic STL31121,,1-Jan-18,14000,,697823,pentaloon,bharatpe,travel
409000611074',INDO GIBL Indiaforensic STL30121,,1-Jan-18,54250,,643573,bigboss,gpay,jewellary
409000611074',INDO GIBL Indiaforensic STL01011,,2-Jan-18,147500,,496073,pentaloon,bharatpe,shopings
409000611074',FDRL/INTERNAL FUND TRANSFE,,3-Jan-18,,500000,996073,,,
409000611074',INDO GIBL Indiaforensic STL02011,,3-Jan-18,323500,,672573,reliance,amazon_pay,insurance
409000611074',INDO GIBL Indiaforensic STL03011,,4-Jan-18,180300,,492273,bigboss,amazon_pay,insurance
409000611074',FDRL/INTERNAL FUND TRANSFE,,5-Jan-18,,500000,992273,,,
409000611074',FDRL/INTERNAL FUND TRANSFE,,5-Jan-18,,500000,1492273,,,
409000611074',INDO GIBL Indiaforensic STL04011,,5-Jan-18,222800,,1269473,uber,amazon_pay,insurance
409000611074',INDO GIBL Indiaforensic STL05011,,6-Jan-18,145450,,1124023,pentaloon,gpay,girl_friend
409000611074',INDO GIBL Indiaforensic STL06011,,9-Jan-18,182000,,942023,mba_chai,zeppay,bill_payments
409000611074',INDO GIBL Indiaforensic STL07011,,9-Jan-18,205075,,736948,uber,paytm,grocery
409000611074',INDO GIBL Indiaforensic STL08011,,9-Jan-18,170500,,566448,pentaloon,zeppay,travel
409000611074',FDRL/INTERNAL FUND TRANSFE,,9-Jan-18,,500000,1066448,,,
409000611074',INDO GIBL Indiaforensic STL09011,,10-Jan-18,495252,,571196,swiggy,paytm,girl_friend
409000611074',INDO GIBL Indiaforensic STL10011,,11-Jan-18,256600,,314596,groffers,paytm,jewellary
409000611074',FDRL/INTERNAL FUND TRANSFE,,12-Jan-18,,500000,814596,,,
409000611074',FDRL/INTERNAL FUND TRANSFE,,12-Jan-18,,500000,1314596,,,
409000611074',FDRL/INTERNAL FUND TRANSFE,,12-Jan-18,,500000,1814596,,,
409000611074',FDRL/INTERNAL FUND TRANSFE,,12-Jan-18,,500000,2314596,,,
409000611074',INDO GIBL Indiaforensic STL14011,,15-Jan-18,5000,,2309596,reliance,phonepe,girl_friend
409000611074',INDO GIBL Indiaforensic STL11011,,15-Jan-18,348200,,1961396,ola,mobikwik,shopings
409000611074',INDO GIBL Indiaforensic STL13011,,15-Jan-18,112900,,1848496,pentaloon,zeppay,shopings
409000611074',INDO GIBL Indiaforensic STL12011,,15-Jan-18,392251,,1456245,pentaloon,gpay,grocery
409000611074',INDO GIBL Indiaforensic STL15011,,16-Jan-18,412300,,1043945,ola,zeppay,grocery
409000611074',INDO GIBL Indiaforensic STL16011,,17-Jan-18,518375,,525570,swiggy,gpay,jewellary
409000611074',INDO GIBL Indiaforensic STL19011,,20-Jan-18,296450,,229120,zomato,hdfc_bank,travel
409000611074',FDRL/INTERNAL FUND TRANSFE,,22-Jan-18,,500000,729120,,,
409000611074',FDRL/INTERNAL FUND TRANSFE,,22-Jan-18,,500000,1229120,,,
409000611074',INDO GIBL Indiaforensic STL22011,,23-Jan-18,274600,,954520,groffers,phonepe,girl_friend
409000611074',INDO GIBL Indiaforensic STL20011,,23-Jan-18,159725,,794795,zomato,hdfc_bank,jewellary
409000611074',INDO GIBL Indiaforensic STL21011,,23-Jan-18,69000,,725795,bigboss,bhim,insurance
409000611074',INDO GIBL Indiaforensic STL18011,,23-Jan-18,244350,,481445,reliance,gpay,shopings
409000611074',INDO GIBL Indiaforensic STL23011,,24-Jan-18,224800,,256645,cred,amazon_pay,wallet
409000611074',FDRL/INTERNAL FUND TRANSFE,,29-Jan-18,,500000,756645,,,
409000611074',FDRL/INTERNAL FUND TRANSFE,,29-Jan-18,,500000,1256645,,,
409000611074',FDRL/INTERNAL FUND TRANSFE,,29-Jan-18,,500000,1756645,,,
409000611074',INDO GIBL Indiaforensic STL25011,,29-Jan-18,135050,,1621595,lenscart,bharatpe,jewellary
409000611074',INDO GIBL Indiaforensic STL26011,,29-Jan-18,31300,,1590295,zomato,paytm,bill_payments
409000611074',INDO GIBL Indiaforensic STL27011,,29-Jan-18,20500,,1569795,groffers,phonepe,wallet
409000611074',INDO GIBL Indiaforensic STL28011,,29-Jan-18,5500,,1564295,groffers,bharatpe,travel
409000611074',INDO GIBL Indiaforensic STL24011,,29-Jan-18,204900,,1359395,pentaloon,paytm,jewellary
409000611074',INDO GIBL Indiaforensic STL17011,,29-Jan-18,563250,,796145,pentaloon,hdfc_bank,withdrawal
409000611074',INDO GIBL Indiaforensic STL29011,,30-Jan-18,207100,,589045,pentaloon,bhim,shopings
409000611074',INDO GIBL Indiaforensic STL30011,,31-Jan-18,138250,,450795,swiggy,bharatpe,girl_friend
409000611074',INDO GIBL Indiaforensic STL31011,,1-Feb-18,196150,,254645,groffers,paytm,withdrawal
409000611074',FDRL/INTERNAL FUND TRANSFE,,2-Feb-18,,500000,754645,,,
409000611074',FDRL/INTERNAL FUND TRANSFE,,2-Feb-18,,500000,1254645,,,
409000611074',FDRL/INTERNAL FUND TRANSFE,,2-Feb-18,,500000,1754645,,,
409000611074',INDO GIBL Indiaforensic STL02021,,3-Feb-18,119675,,1634970,groffers,bhim,girl_friend
409000611074',INDO GIBL Indiaforensic STL01021,,3-Feb-18,137775,,1497195,ola,mobikwik,jewellary
409000611074',INDO GIBL Indiaforensic STL03021,,7-Feb-18,61500,,1435695,mba_chai,zeppay,travel
409000611074',INDO GIBL Indiaforensic STL05021,,7-Feb-18,138350,,1297345,groffers,zeppay,wallet
409000611074',INDO GIBL Indiaforensic STL06021,,7-Feb-18,239400,,1057945,reliance,hdfc_bank,grocery
409000611074',FDRL/INTERNAL FUND TRANSFE,,8-Feb-18,,500000,1557945,,,
409000611074',FDRL/INTERNAL FUND TRANSFE,,8-Feb-18,,500000,2057945,,,
409000611074',INDO GIBL Indiaforensic STL07021,,9-Feb-18,271124,,1786821,ola,bhim,insurance
409000611074',INDO GIBL Indiaforensic STL08021,,9-Feb-18,300799,,1486022,bigboss,amazon_pay,grocery
409000611074',INDO GIBL Indiaforensic STL09021,,16-Feb-18,334900,,1151122,swiggy,gpay,bill_payments
409000611074',INDO GIBL Indiaforensic STL10021,,16-Feb-18,68250,,1082872,pentaloon,hdfc_bank,wallet
409000611074',INDO GIBL Indiaforensic STL13021,,16-Feb-18,307125,,775747,lenscart,paytm,travel
409000611074',INDO GIBL Indiaforensic STL14021,,16-Feb-18,475300,,300447,cred,phonepe,grocery
409000611074',FDRL/INTERNAL FUND TRANSFE,,16-Feb-18,,500000,800447,,,
409000611074',FDRL/INTERNAL FUND TRANSFE,,16-Feb-18,,500000,1300447,,,
409000611074',FDRL/INTERNAL FUND TRANSFE,,16-Feb-18,,500000,1800447,,,
409000611074',INDO GIBL Indiaforensic STL12021,,17-Feb-18,594328,,1206119,bigboss,gpay,withdrawal
409000611074',INDO GIBL Indiaforensic STL15021,,17-Feb-18,387100,,819019,ola,bharatpe,wallet
409000611074',FDRL/INTERNAL FUND TRANSFE,,19-Feb-18,,500000,1319019,,,
409000611074',INDO GIBL Indiaforensic STL16021,,21-Feb-18,710800,,608219,lenscart,paytm,travel
409000611074',INDO GIBL Indiaforensic STL17021,,21-Feb-18,385400,,222819,uber,gpay,wallet
409000611074',FDRL/INTERNAL FUND TRANSFE,,22-Feb-18,,500000,722819,,,
409000611074',FDRL/INTERNAL FUND TRANSFE,,22-Feb-18,,500000,1222819,,,
409000611074',INDO GIBL Indiaforensic STL18021,,22-Feb-18,79350,,1143469,ola,gpay,bill_payments
409000611074',INDO GIBL Indiaforensic STL19021,,22-Feb-18,385200,,758269,uber,gpay,jewellary
409000611074',INDO GIBL Indiaforensic STL20021,,22-Feb-18,299950,,458319,uber,mobikwik,jewellary
409000611074',FDRL/INTERNAL FUND TRANSFE,,22-Feb-18,,500000,958319,,,
409000611074',FDRL/INTERNAL FUND TRANSFE,,23-Feb-18,,500000,1458319,,,
409000611074',INDO GIBL Indiaforensic STL21021,,26-Feb-18,273500,,1184819,groffers,gpay,bill_payments
409000611074',INDO GIBL Indiaforensic STL22021,,26-Feb-18,237500,,947319,groffers,mobikwik,shopings
409000611074',INDO GIBL Indiaforensic STL23021,,26-Feb-18,277753,,669566,groffers,bharatpe,wallet
409000611074',INDO GIBL Indiaforensic STL24021,,26-Feb-18,70300,,599266,lenscart,amazon_pay,bill_payments
409000611074',INDO GIBL Indiaforensic STL25021,,26-Feb-18,62400,,536866,reliance,amazon_pay,jewellary
409000611074',FDRL/INTERNAL FUND TRANSFE,,26-Feb-18,,500000,1036866,,,
409000611074',FDRL/INTERNAL FUND TRANSFE,,26-Feb-18,,500000,1536866,,,
409000611074',INDO GIBL Indiaforensic STL26021,,27-Feb-18,103300,,1433566,groffers,paytm,grocery
409000611074',INDO GIBL Indiaforensic STL27021,,28-Feb-18,182450,,1251116,lenscart,amazon_pay,travel
409000611074',FDRL/INTERNAL FUND TRANSFE,,1-Mar-18,,500000,1751116,,,
409000611074',FDRL/INTERNAL FUND TRANSFE,,1-Mar-18,,500000,2251116,,,
409000611074',INDO GIBL Indiaforensic STL03031,,5-Mar-18,155500,,2095616,mba_chai,phonepe,wallet
409000611074',INDO GIBL Indiaforensic STL28021,,7-Mar-18,244350,,1851266,swiggy,amazon_pay,grocery
409000611074',INDO GIBL Indiaforensic STL01031,,7-Mar-18,202799,,1648467,reliance,zeppay,shopings
409000611074',INDO GIBL Indiaforensic STL03031,,7-Mar-18,155500,,1492967,mba_chai,hdfc_bank,shopings
409000611074',INDO GIBL Indiaforensic STL05031,,7-Mar-18,153300,,1339667,reliance,mobikwik,withdrawal
409000611074',INDO GIBL Indiaforensic STL06031,,7-Mar-18,350150,,989517,zomato,phonepe,wallet
409000611074',INDO GIBL Indiaforensic STL07031,,8-Mar-18,371900,,617617,bigboss,zeppay,bill_payments
409000611074',INDO GIBL Indiaforensic STL08031,,9-Mar-18,345930,,271687,ola,hdfc_bank,shopings
409000611074',FDRL/INTERNAL FUND TRANSFE,,9-Mar-18,,500000,771687,,,
409000611074',FDRL/INTERNAL FUND TRANSFE,,9-Mar-18,,500000,1271687,,,
409000611074',INDO GIBL Indiaforensic STL09031,,12-Mar-18,390850,,880837,uber,bhim,wallet
409000611074',INDO GIBL Indiaforensic STL1003,,12-Mar-18,85800,,795037,uber,hdfc_bank,wallet
409000611074',INDO GIBL Indiaforensic STL11031,,12-Mar-18,45000,,750037,ola,amazon_pay,jewellary
409000611074',FDRL/INTERNAL FUND TRANSFE,,12-Mar-18,,500000,1250037,,,
409000611074',FDRL/INTERNAL FUND TRANSFE,,12-Mar-18,,500000,1750037,,,
409000611074',INDO GIBL Indiaforensic STL12031,,13-Mar-18,577493,,1172544,uber,bharatpe,jewellary
409000611074',INDO GIBL Indiaforensic STL13031,,14-Mar-18,556224,,616320,swiggy,bharatpe,grocery
409000611074',FDRL/INTERNAL FUND TRANSFE,,14-Mar-18,,500000,1116320,,,
409000611074',FDRL/INTERNAL FUND TRANSFE,,14-Mar-18,,500000,1616320,,,
409000611074',INDO GIBL Indiaforensic STL14031,,15-Mar-18,425700,,1190620,reliance,phonepe,girl_friend
409000611074',INDO GIBL Indiaforensic STL15031,,16-Mar-18,213463,,977157,swiggy,bharatpe,withdrawal
409000611074',FDRL/INTERNAL FUND TRANSFE,,16-Mar-18,,500000,1477157,,,
409000611074',INDO GIBL Indiaforensic STL16031,,17-Mar-18,199983,,1277174,cred,gpay,travel
409000611074',INDO GIBL Indiaforensic STL17031,,19-Mar-18,230510,,1046664,lenscart,phonepe,girl_friend
409000611074',INDO GIBL Indiaforensic STL18031,,19-Mar-18,10000,,1036664,lenscart,amazon_pay,shopings
409000611074',INDO GIBL Indiaforensic STL19031,,20-Mar-18,335250,,701414,zomato,mobikwik,girl_friend
409000611074',FDRL/INTERNAL FUND TRANSFE,,20-Mar-18,,500000,1201414,,,
409000611074',Indfor INCM INDO REVREMI0303,,20-Mar-18,,1320,1202734,,,
409000611074',INDO GIBLOXGN REVSTL03031,,20-Mar-18,,155500,1358234,,,
409000611074',Indfor INCM INDO REVREMI0103,,20-Mar-18,,202799,1561033,,,
409000611074',INDO GIBL Indiaforensic STL01031,,20-Mar-18,200799,,1360234,zomato,paytm,shopings
409000611074',INDO GIBL Indiaforensic STL20031,,22-Mar-18,434450,,925784,reliance,phonepe,wallet
409000611074',INDO GIBL Indiaforensic STL21031,,22-Mar-18,292175,,633609,lenscart,mobikwik,withdrawal
409000611074',FDRL/INTERNAL FUND TRANSFE,,22-Mar-18,,500000,1133609,,,
409000611074',FDRL/INTERNAL FUND TRANSFE,,22-Mar-18,,500000,1633609,,,
409000611074',INDO GIBL Indiaforensic STL22031,,23-Mar-18,301200,,1332409,cred,zeppay,shopings
409000611074',FDRL/INTERNAL FUND TRANSFE,,23-Mar-18,,500000,1832409,,,
409000611074',INDO GIBL Indiaforensic STL23031,,26-Mar-18,218975,,1613434,pentaloon,amazon_pay,wallet
409000611074',INDO GIBL Indiaforensic STL24031,,26-Mar-18,44800,,1568634,groffers,gpay,shopings
409000611074',INDO GIBL Indiaforensic STL25031,,26-Mar-18,12000,,1556634,zomato,amazon_pay,grocery
409000611074',INDO GIBL Indiaforensic STL26031,,27-Mar-18,259150,,1297484,bigboss,mobikwik,insurance
409000611074',INDO GIBL Indiaforensic STL27031,,28-Mar-18,139650,,1157834,cred,bharatpe,shopings
409000611074',INDO GIBL Indiaforensic STL28031,,31-Mar-18,164600,,993234,reliance,amazon_pay,wallet
409000611074',INDO GIBL Indiaforensic STL29031,,31-Mar-18,81675,,911559,mba_chai,bharatpe,jewellary
409000611074',INDO GIBL Indiaforensic STL30031,,31-Mar-18,85750,,825809,zomato,hdfc_bank,insurance
409000611074',FDRL/INTERNAL FUND TRANSFE,,31-Mar-18,,500000,1325809,,,
409000611074',FDRL/INTERNAL FUND TRANSFE,,5-Apr-18,,500000,1825809,,,
409000611074',FDRL/INTERNAL FUND TRANSFE,,5-Apr-18,,500000,2325809,,,
409000611074',INDO GIBL Indiaforensic STL31031,,6-Apr-18,150950,,2174859,mba_chai,mobikwik,insurance
409000611074',INDO GIBL Indiaforensic STL01041,,6-Apr-18,20000,,2154859,mba_chai,zeppay,jewellary
409000611074',INDO GIBL Indiaforensic STL02041,,6-Apr-18,26400,,2128459,swiggy,bharatpe,travel
409000611074',INDO GIBL Indiaforensic STL03041,,6-Apr-18,109650,,2018809,ola,mobikwik,bill_payments
409000611074',INDO GIBL Indiaforensic STL04041,,6-Apr-18,318100,,1700709,swiggy,mobikwik,wallet
409000611074',INDO GIBL Indiaforensic STL05041,,6-Apr-18,309200,,1391509,mba_chai,zeppay,girl_friend
409000611074',INDO GIBL Indiaforensic STL06041,,7-Apr-18,303600,,1087909,zomato,phonepe,wallet
409000611074',INDO GIBL Indiaforensic STL07041,,9-Apr-18,48800,,1039109,groffers,hdfc_bank,grocery
409000611074',FDRL/INTERNAL FUND TRANSFE,,9-Apr-18,,500000,1539109,,,
409000611074',INDO GIBL Indiaforensic STL09041,,10-Apr-18,305950,,1233159,mba_chai,phonepe,girl_friend
409000611074',FDRL/INTERNAL FUND TRANSFE,,11-Apr-18,,500000,1733159,,,
409000611074',INDO GIBL Indiaforensic STL10041,,11-Apr-18,162600,,1570559,bigboss,gpay,wallet
409000611074',INDO GIBL Indiaforensic STL11041,,12-Apr-18,639700,,930859,zomato,mobikwik,girl_friend
409000611074',FDRL/INTERNAL FUND TRANSFE,,12-Apr-18,,500000,1430859,,,
409000611074',INDO GIBL Indiaforensic STL12041,,13-Apr-18,363900,,1066959,mba_chai,paytm,withdrawal
409000611074',FDRL/INTERNAL FUND TRANSFE,,13-Apr-18,,500000,1566959,,,
409000611074',FDRL/INTERNAL FUND TRANSFE,,13-Apr-18,,500000,2066959,,,
409000611074',INDO GIBL Indiaforensic STL13041,,16-Apr-18,347950,,1719009,lenscart,paytm,insurance
409000611074',INDO GIBL Indiaforensic STL14041,,16-Apr-18,76900,,1642109,pentaloon,mobikwik,shopings
409000611074',INDO GIBL Indiaforensic STL15041,,16-Apr-18,48000,,1594109,mba_chai,zeppay,insurance
409000611074',INDO GIBL Indiaforensic STL16041,,17-Apr-18,555650,,1038459,pentaloon,amazon_pay,travel
409000611074',FDRL/INTERNAL FUND TRANSFE,,18-Apr-18,,500000,1538459,,,
409000611074',INDO GIBL Indiaforensic STL17041,,18-Apr-18,574150,,964309,zomato,zeppay,travel
409000611074',INDO GIBL Indiaforensic STL18041,,19-Apr-18,388550,,575759,ola,amazon_pay,travel
409000611074',FDRL/INTERNAL FUND TRANSFE,,19-Apr-18,,500000,1075759,,,
409000611074',INDO GIBL Indiaforensic STL19041,,20-Apr-18,276300,,799459,cred,gpay,bill_payments
409000611074',INDO GIBL Indiaforensic STL20041,,21-Apr-18,167591,,631868,bigboss,amazon_pay,girl_friend
409000611074',FDRL/INTERNAL FUND TRANSFE,,21-Apr-18,,500000,1131868,,,
409000611074',FDRL/INTERNAL FUND TRANSFE,,21-Apr-18,,500000,1631868,,,
409000611074',INDO GIBL Indiaforensic STL21041,,25-Apr-18,242700,,1389168,swiggy,gpay,wallet
409000611074',INDO GIBL Indiaforensic STL22041,,25-Apr-18,92900,,1296268,cred,bharatpe,withdrawal
409000611074',INDO GIBL Indiaforensic STL23041,,25-Apr-18,315750,,980518,zomato,phonepe,shopings
409000611074',INDO GIBL Indiaforensic STL24041,,25-Apr-18,377300,,603218,zomato,amazon_pay,insurance
409000611074',FDRL/INTERNAL FUND TRANSFE,,26-Apr-18,,500000,1103218,,,
409000611074',FDRL/INTERNAL FUND TRANSFE,,26-Apr-18,,500000,1603218,,,
409000611074',INDO GIBL Indiaforensic STL25041,,27-Apr-18,414276,,1188942,cred,zeppay,wallet
409000611074',INDO GIBL Indiaforensic STL26041,,27-Apr-18,351100,,837842,swiggy,hdfc_bank,withdrawal
409000611074',FDRL/INTERNAL FUND TRANSFE,,27-Apr-18,,500000,1337842,,,
409000611074',FDRL/INTERNAL FUND TRANSFE,,1-May-18,,500000,1837842,,,
409000611074',INDO GIBL Indiaforensic STL27041,,2-May-18,229949,,1607893,reliance,amazon_pay,travel
409000611074',INDO GIBL Indiaforensic STL28041,,2-May-18,160300,,1447593,cred,zeppay,travel
409000611074',INDO GIBL Indiaforensic STL29041,,2-May-18,76000,,1371593,lenscart,zeppay,travel
409000611074',INDO GIBL Indiaforensic STL30041,,2-May-18,60449,,1311144,uber,mobikwik,girl_friend
409000611074',INDO GIBL Indiaforensic STL01051,,2-May-18,259075,,1052069,cred,hdfc_bank,shopings
409000611074',FDRL/INTERNAL FUND TRANSFE,,2-May-18,,500000,1552069,,,
409000611074',INDO GIBL Indiaforensic STL02051,,3-May-18,206700,,1345369,cred,amazon_pay,wallet
409000611074',FDRL/INTERNAL FUND TRANSFE,,3-May-18,,500000,1845369,,,
409000611074',INDO GIBL Indiaforensic STL03051,,4-May-18,237000,,1608369,mba_chai,bhim,bill_payments
409000611074',INDO GIBL Indiaforensic STL04051,,5-May-18,272000,,1336369,zomato,bhim,withdrawal
409000611074',INDO GIBL Indiaforensic STL05051,,7-May-18,387749,,948620,uber,phonepe,bill_payments
409000611074',INDO GIBL Indiaforensic STL06051,,7-May-18,101050,,847570,bigboss,amazon_pay,insurance
409000611074',FDRL/INTERNAL FUND TRANSFE,,7-May-18,,500000,1347570,,,
409000611074',INDO GIBL Indiaforensic STL07051,,8-May-18,392900,,954670,groffers,zeppay,girl_friend
409000611074',INDO GIBL Indiaforensic STL08051,,9-May-18,290350,,664320,swiggy,zeppay,travel
409000611074',FDRL/INTERNAL FUND TRANSFE,,9-May-18,,500000,1164320,,,
409000611074',FDRL/INTERNAL FUND TRANSFE,,9-May-18,,500000,1664320,,,
409000611074',INDO GIBL Indiaforensic STL09051,,10-May-18,365625,,1298695,pentaloon,bharatpe,girl_friend
409000611074',INDO GIBL Indiaforensic STL10051,,11-May-18,352850,,945845,swiggy,paytm,girl_friend
409000611074',FDRL/INTERNAL FUND TRANSFE,,11-May-18,,500000,1445845,,,
409000611074',INDO GIBL Indiaforensic STL11051,,14-May-18,345749,,1100096,lenscart,hdfc_bank,shopings
409000611074',INDO GIBL Indiaforensic STL12051,,14-May-18,225300,,874796,pentaloon,hdfc_bank,bill_payments
409000611074',INDO GIBL Indiaforensic STL13051,,14-May-18,10000,,864796,pentaloon,bharatpe,shopings
409000611074',FDRL/INTERNAL FUND TRANSFE,,14-May-18,,500000,1364796,,,
409000611074',INDO GIBL Indiaforensic STL14051,,15-May-18,823240,,541556,cred,amazon_pay,wallet
409000611074',FDRL/INTERNAL FUND TRANSFE,,15-May-18,,500000,1041556,,,
409000611074',FDRL/INTERNAL FUND TRANSFE,,15-May-18,,500000,1541556,,,
409000611074',INDO GIBL Indiaforensic STL15051,,16-May-18,785049,,756507,swiggy,paytm,withdrawal
409000611074',FDRL/INTERNAL FUND TRANSFE,,17-May-18,,500000,1256507,,,
409000611074',INDO GIBL Indiaforensic STL16051,,17-May-18,403100,,853407,cred,zeppay,travel
409000611074',FDRL/INTERNAL FUND TRANSFE,,17-May-18,,500000,1353407,,,
409000611074',INDO GIBL Indiaforensic STL17051,,18-May-18,459800,,893607,ola,paytm,jewellary
409000611074',FDRL/INTERNAL FUND TRANSFE,,18-May-18,,500000,1393607,,,
409000611074',INDO GIBL Indiaforensic STL18051,,19-May-18,373850,,1019757,reliance,hdfc_bank,shopings
409000611074',INDO GIBL Indiaforensic STL19051,,21-May-18,265500,,754257,ola,paytm,jewellary
409000611074',INDO GIBL Indiaforensic STL20051,,21-May-18,25700,,728557,mba_chai,mobikwik,withdrawal
409000611074',FDRL/INTERNAL FUND TRANSFE,,21-May-18,,500000,1228557,,,
409000611074',INDO GIBL Indiaforensic STL21051,,22-May-18,376125,,852432,uber,phonepe,bill_payments
409000611074',FDRL/INTERNAL FUND TRANSFE,,22-May-18,,500000,1352432,,,
409000611074',INDO GIBL Indiaforensic STL22051,,23-May-18,265250,,1087182,uber,hdfc_bank,travel
409000611074',INDO GIBL Indiaforensic STL23051,,24-May-18,119100,,968082,lenscart,paytm,grocery
409000611074',FDRL/INTERNAL FUND TRANSFE,,24-May-18,,500000,1468082,,,
409000611074',INDO GIBL Indiaforensic STL24051,,25-May-18,93350,,1374732,swiggy,gpay,grocery
409000611074',INDO GIBL Indiaforensic STL25051,,28-May-18,201000,,1173732,zomato,zeppay,jewellary
409000611074',INDO GIBL Indiaforensic STL26051,,28-May-18,80475,,1093257,lenscart,hdfc_bank,wallet
409000611074',INDO GIBL Indiaforensic STL27051,,28-May-18,27200,,1066057,reliance,paytm,grocery
409000611074',FDRL/INTERNAL FUND TRANSFE,,28-May-18,,500000,1566057,,,
409000611074',INDO GIBL Indiaforensic STL28051,,29-May-18,364100,,1201957,bigboss,paytm,girl_friend
409000611074',INDO GIBL Indiaforensic STL29051,,30-May-18,341200,,860757,uber,paytm,travel
409000611074',FDRL/INTERNAL FUND TRANSFE,,30-May-18,,500000,1360757,,,
409000611074',INDO GIBL Indiaforensic STL30051,,31-May-18,234600,,1126157,reliance,bharatpe,jewellary
409000611074',FDRL/INTERNAL FUND TRANSFE,,1-Jun-18,,500000,1626157,,,
409000611074',INDO GIBL Indiaforensic STL31051,,1-Jun-18,78000,,1548157,pentaloon,bharatpe,grocery
409000611074',INDO GIBL Indiaforensic STL01061,,2-Jun-18,353500,,1194657,swiggy,paytm,travel
409000611074',FDRL/INTERNAL FUND TRANSFE,,4-Jun-18,,500000,1694657,,,
409000611074',INDO GIBL Indiaforensic STL02061,,4-Jun-18,402850,,1291807,reliance,bharatpe,insurance
409000611074',INDO GIBL Indiaforensic STL04061,,5-Jun-18,578750,,713057,pentaloon,zeppay,insurance
409000611074',INDO GIBL Indiaforensic STL05061,,6-Jun-18,251200,,461857,ola,bharatpe,shopings
409000611074',FDRL/INTERNAL FUND TRANSFE,,6-Jun-18,,500000,961857,,,
409000611074',FDRL/INTERNAL FUND TRANSFE,,6-Jun-18,,500000,1461857,,,
409000611074',INDO GIBL Indiaforensic STL06061,,7-Jun-18,217075,,1244782,reliance,hdfc_bank,shopings
409000611074',INDO GIBL Indiaforensic STL07061,,8-Jun-18,491005,,753777,zomato,amazon_pay,grocery
409000611074',FDRL/INTERNAL FUND TRANSFE,,11-Jun-18,,500000,1253777,,,
409000611074',FDRL/INTERNAL FUND TRANSFE,,11-Jun-18,,500000,1753777,,,
409000611074',INDO GIBL Indiaforensic STL08061,,11-Jun-18,626600,,1127177,ola,zeppay,travel
409000611074',INDO GIBL Indiaforensic STL09061,,11-Jun-18,340074,,787103,cred,paytm,bill_payments
409000611074',INDO GIBL Indiaforensic STL10061,,11-Jun-18,24176,,762927,swiggy,amazon_pay,girl_friend
409000611074',FDRL/INTERNAL FUND TRANSFE,,12-Jun-18,,500000,1262927,,,
409000611074',FDRL/INTERNAL FUND TRANSFE,,12-Jun-18,,500000,1762927,,,
409000611074',INDO GIBL Indiaforensic STL11061,,12-Jun-18,793251,,969676,swiggy,phonepe,grocery
409000611074',FDRL/INTERNAL FUND TRANSFE,,13-Jun-18,,500000,1469676,,,
409000611074',INDO GIBL Indiaforensic STL12061,,13-Jun-18,717850,,751826,lenscart,mobikwik,insurance
409000611074',INDO GIBL Indiaforensic STL27041,,13-Jun-18,32000,,719826,cred,gpay,travel
409000611074',FDRL/INTERNAL FUND TRANSFE,,13-Jun-18,,500000,1219826,,,
409000611074',FDRL/INTERNAL FUND TRANSFE,,14-Jun-18,,1000000,2219826,,,
409000611074',INDO GIBL Indiaforensic STL13061,,14-Jun-18,533800,,1686026,cred,hdfc_bank,shopings
409000611074',INDO GIBL Indiaforensic STL14061,,15-Jun-18,559730,,1126296,cred,bharatpe,shopings
409000611074',FDRL/INTERNAL FUND TRANSFE,,15-Jun-18,,1000000,2126296,,,
409000611074',INDO GIBL Indiaforensic STL17061,,18-Jun-18,52250,,2074046,groffers,gpay,withdrawal
409000611074',INDO GIBL Indiaforensic STL16061,,18-Jun-18,140750,,1933296,pentaloon,bharatpe,girl_friend
409000611074',INDO GIBL Indiaforensic STL15061,,18-Jun-18,325200,,1608096,mba_chai,bhim,shopings
409000611074',FDRL/INTERNAL FUND TRANSFE,,19-Jun-18,,500000,2108096,,,
409000611074',INDO GIBL Indiaforensic STL18061,,19-Jun-18,709200,,1398896,groffers,amazon_pay,bill_payments
409000611074',FDRL/INTERNAL FUND TRANSFE,,20-Jun-18,,500000,1898896,,,
409000611074',INDO GIBL Indiaforensic STL19061,,20-Jun-18,689650,,1209246,zomato,phonepe,grocery
409000611074',FDRL/INTERNAL FUND TRANSFE,,21-Jun-18,,500000,1709246,,,
409000611074',INDO GIBL Indiaforensic STL20061,,21-Jun-18,386200,,1323046,bigboss,amazon_pay,girl_friend
409000611074',INDO GIBL Indiaforensic STL21061,,22-Jun-18,434905,,888141,pentaloon,gpay,travel
409000611074',FDRL/INTERNAL FUND TRANSFE,,22-Jun-18,,1000000,1888141,,,
409000611074',INDO GIBL Indiaforensic STL24061,,25-Jun-18,6050,,1882091,pentaloon,zeppay,girl_friend
409000611074',INDO GIBL Indiaforensic STL23061,,25-Jun-18,115051,,1767040,cred,phonepe,shopings
409000611074',INDO GIBL Indiaforensic STL22061,,25-Jun-18,242750,,1524290,uber,mobikwik,grocery
409000611074',TRF FROM  Indiaforensic SERVICES,,25-Jun-18,,500000,2024290,,,
409000611074',INDO GIBL Indiaforensic STL25061,,26-Jun-18,261438,,1762852,uber,mobikwik,insurance
409000611074',INDO GIBL Indiaforensic STL26061,,27-Jun-18,528175,,1234677,reliance,bharatpe,insurance
409000611074',FDRL/INTERNAL FUND TRANSFE,,28-Jun-18,,500000,1734677,,,
409000611074',GIBLRBL INC INDO REM27061,,28-Jun-18,2640,,1732037,lenscart,mobikwik,girl_friend
409000611074',INDO MFL STL270618,,28-Jun-18,344750,,1387287,lenscart,gpay,withdrawal
409000611074',Indfor INCOME INDO REMI28061,,29-Jun-18,2160,,1385127,groffers,paytm,bill_payments
409000611074',INDO GIBL Indiaforensic STL28061,,29-Jun-18,410181,,974946,ola,gpay,withdrawal
409000611074',FDRL/INTERNAL FUND TRANSFE,,29-Jun-18,,500000,1474946,,,
409000611074',Indfor INCOME INDO REMI29061,,30-Jun-18,1320,,1473626,cred,bharatpe,shopings
409000611074',INDO GIBL Indiaforensic STL29061,,30-Jun-18,176050,,1297576,reliance,zeppay,bill_payments
409000611074',FDRL/INTERNAL FUND TRANSFE,,2-Jul-18,,500000,1797576,,,
409000611074',Indfor INCOME INDO REMI30061,,2-Jul-18,960,,1796616,lenscart,paytm,jewellary
409000611074',INDO GIBL Indiaforensic STL30061,,2-Jul-18,200250,,1596366,zomato,hdfc_bank,wallet
409000611074',Indfor INCOME INDO REMI01071,,2-Jul-18,120,,1596246,uber,bharatpe,bill_payments
409000611074',INDO GIBL Indiaforensic STL01071,,2-Jul-18,10000,,1586246,lenscart,amazon_pay,girl_friend
409000611074',Indfor INCOME INDO REMI02071,,4-Jul-18,2280,,1583966,cred,amazon_pay,insurance
409000611074',INDO GIBL Indiaforensic STL02071,,4-Jul-18,282208,,1301758,ola,mobikwik,withdrawal
409000611074',FDRL/INTERNAL FUND TRANSFE,,4-Jul-18,,500000,1801758,,,
409000611074',Indfor INCOME INDO REMI03071,,4-Jul-18,2280,,1799478,bigboss,paytm,jewellary
409000611074',INDO GIBL Indiaforensic STL03071,,4-Jul-18,323700,,1475778,uber,phonepe,withdrawal
409000611074',Indfor INCOME INDO REMI04071,,5-Jul-18,3840,,1471938,uber,hdfc_bank,bill_payments
409000611074',INDO GIBL Indiaforensic STL04071,,5-Jul-18,528300,,943638,reliance,bhim,wallet
409000611074',Indfor INCOME INDO REMI05071,,6-Jul-18,2520,,941118,swiggy,phonepe,insurance
409000611074',INDO GIBL Indiaforensic STL05071,,6-Jul-18,431899,,509219,groffers,bharatpe,girl_friend
409000611074',FDRL/INTERNAL FUND TRANSFE,,6-Jul-18,,500000,1009219,,,
409000611074',Indfor INCOME INDO REMI06071,,7-Jul-18,2640,,1006579,uber,phonepe,bill_payments
409000611074',INDO GIBL Indiaforensic STL06071,,7-Jul-18,295000,,711579,pentaloon,amazon_pay,shopings
409000611074',FDRL/INTERNAL FUND TRANSFE,,7-Jul-18,,500000,1211579,,,
409000611074',Indfor INCOME INDO REMI08071,,9-Jul-18,120,,1211459,swiggy,amazon_pay,grocery
409000611074',INDO GIBL Indiaforensic STL08071,,9-Jul-18,30700,,1180759,reliance,amazon_pay,wallet
409000611074',Indfor INCOME INDO REMI07071,,9-Jul-18,1200,,1179559,ola,amazon_pay,bill_payments
409000611074',INDO GIBL Indiaforensic STL07071,,9-Jul-18,213225,,966334,cred,paytm,travel
409000611074',FDRL/INTERNAL FUND TRANSFE,,9-Jul-18,,500000,1466334,,,
409000611074',Indfor INCOME INDO REMI09071,,10-Jul-18,4800,,1461534,groffers,bhim,insurance
409000611074',INDO GIBL Indiaforensic STL09071,,10-Jul-18,809926,,651608,cred,amazon_pay,wallet
409000611074',FDRL/INTERNAL FUND TRANSFE,,10-Jul-18,,500000,1151608,,,
409000611074',Indfor INCOME INDO REMI10071,,11-Jul-18,2640,,1148968,bigboss,bhim,wallet
409000611074',INDO GIBL Indiaforensic STL10071,,11-Jul-18,435225,,713743,swiggy,amazon_pay,insurance
409000611074',FDRL/INTERNAL FUND TRANSFE,,11-Jul-18,,500000,1213743,,,
409000611074',FDRL/INTERNAL FUND TRANSFE,,12-Jul-18,,500000,1713743,,,
409000611074',Indfor INCOME INDO REMI11071,,12-Jul-18,4560,,1709183,lenscart,hdfc_bank,girl_friend
409000611074',INDO GIBL Indiaforensic STL11071,,12-Jul-18,828988,,880195,pentaloon,bhim,travel
409000611074',FDRL/INTERNAL FUND TRANSFE,,12-Jul-18,,500000,1380195,,,
409000611074',Indfor INCOME INDO REMI12071,,13-Jul-18,3120,,1377075,ola,zeppay,jewellary
409000611074',INDO GIBL Indiaforensic STL12071,,13-Jul-18,447455,,929620,ola,amazon_pay,grocery
409000611074',FDRL/INTERNAL FUND TRANSFE,,13-Jul-18,,500000,1429620,,,
409000611074',FDRL/INTERNAL FUND TRANSFE,,13-Jul-18,,200000,1629620,,,
409000611074',Indfor INCOME INDO REMI15071,,16-Jul-18,360,,1629260,mba_chai,bharatpe,girl_friend
409000611074',INDO GIBL Indiaforensic STL15071,,16-Jul-18,69800,,1559460,bigboss,amazon_pay,shopings
409000611074',Indfor INCOME INDO REMI14071,,16-Jul-18,840,,1558620,cred,phonepe,girl_friend
409000611074',INDO GIBL Indiaforensic STL14071,,16-Jul-18,121300,,1437320,bigboss,bhim,jewellary
409000611074',Indfor INCOME INDO REMI13071,,16-Jul-18,3000,,1434320,groffers,bharatpe,girl_friend
409000611074',INDO GIBL Indiaforensic STL13071,,16-Jul-18,505300,,929020,uber,amazon_pay,wallet
409000611074',FDRL/INTERNAL FUND TRANSFE,,17-Jul-18,,200000,1129020,,,
409000611074',FDRL/INTERNAL FUND TRANSFE,,17-Jul-18,,500000,1629020,,,
409000611074',Indfor INCOME INDO REMI16071,,17-Jul-18,4080,,1624940,mba_chai,amazon_pay,travel
409000611074',INDO GIBL Indiaforensic STL16071,,17-Jul-18,717000,,907940,reliance,mobikwik,insurance
409000611074',FDRL/INTERNAL FUND TRANSFE,,17-Jul-18,,200000,1107940,,,
409000611074',FDRL/INTERNAL FUND TRANSFE,,17-Jul-18,,200000,1307940,,,
409000611074',Indfor INCOME INDO REMI17071,,18-Jul-18,3960,,1303980,reliance,hdfc_bank,travel
409000611074',INDO GIBL Indiaforensic STL17071,,18-Jul-18,581900,,722080,ola,paytm,girl_friend
409000611074',FDRL/INTERNAL FUND TRANSFE,,18-Jul-18,,200000,922080,,,
409000611074',FDRL/INTERNAL FUND TRANSFE,,18-Jul-18,,200000,1122080,,,
409000611074',FDRL/INTERNAL FUND TRANSFE,,18-Jul-18,,200000,1322080,,,
409000611074',FDRL/INTERNAL FUND TRANSFE,,18-Jul-18,,200000,1522080,,,
409000611074',FDRL/INTERNAL FUND TRANSFE,,19-Jul-18,,200000,1722080,,,
409000611074',FDRL/INTERNAL FUND TRANSFE,,19-Jul-18,,200000,1922080,,,
409000611074',Indfor INCOME INDO REMI18071,,19-Jul-18,3600,,1918480,mba_chai,mobikwik,bill_payments
409000611074',INDO GIBL Indiaforensic STL18071,,19-Jul-18,663350,,1255130,cred,gpay,travel
409000611074',Indfor INCOME INDO REMI19071,,20-Jul-18,1440,,1253690,lenscart,phonepe,bill_payments
409000611074',INDO GIBL Indiaforensic STL19071,,20-Jul-18,135800,,1117890,lenscart,hdfc_bank,withdrawal
409000611074',FDRL/INTERNAL FUND TRANSFE,,20-Jul-18,,300000,1417890,,,
409000611074',Indfor INCOME INDO REMI20071,,21-Jul-18,3600,,1414290,groffers,zeppay,bill_payments
409000611074',INDO GIBL Indiaforensic STL20071,,21-Jul-18,712099,,702191,ola,hdfc_bank,travel
409000611074',FDRL/INTERNAL FUND TRANSFE,,21-Jul-18,,1000000,1702191,,,
409000611074',FDRL/INTERNAL FUND TRANSFE,,23-Jul-18,,300000,2002191,,,
409000611074',Indfor INCOME INDO REMI22071,,23-Jul-18,840,,2001351,ola,bhim,jewellary
409000611074',INDO GIBL Indiaforensic STL22071,,23-Jul-18,145400,,1855951,cred,bharatpe,travel
409000611074',Indfor INCOME INDO REMI21071,,23-Jul-18,1920,,1854031,ola,hdfc_bank,grocery
409000611074',INDO GIBL Indiaforensic STL21071,,23-Jul-18,240535,,1613496,ola,paytm,girl_friend
409000611074',Indfor INCOME INDO REMI23071,,24-Jul-18,3840,,1609656,lenscart,amazon_pay,travel
409000611074',INDO GIBL Indiaforensic STL23071,,24-Jul-18,610100,,999556,swiggy,mobikwik,insurance
409000611074',FDRL/INTERNAL FUND TRANSFE,,25-Jul-18,,500000,1499556,,,
409000611074',Indfor INCOME INDO REMI24071,,25-Jul-18,3360,,1496196,zomato,mobikwik,jewellary
409000611074',INDO GIBL Indiaforensic STL24071,,25-Jul-18,518500,,977696,reliance,gpay,girl_friend
409000611074',FDRL/INTERNAL FUND TRANSFE,,25-Jul-18,,300000,1277696,,,
409000611074',FDRL/INTERNAL FUND TRANSFE,,25-Jul-18,,300000,1577696,,,
409000611074',Indfor INCOME INDO REMI25071,,26-Jul-18,3240,,1574456,bigboss,mobikwik,grocery
409000611074',INDO GIBL Indiaforensic STL25071,,26-Jul-18,442250,,1132206,zomato,zeppay,travel
409000611074',FDRL/INTERNAL FUND TRANSFE,,26-Jul-18,,300000,1432206,,,
409000611074',Indfor INCOME INDO REMI26071,,27-Jul-18,3240,,1428966,groffers,bhim,bill_payments
409000611074',INDO GIBL Indiaforensic STL26071,,27-Jul-18,389600,,1039366,lenscart,amazon_pay,wallet
409000611074',FDRL/INTERNAL FUND TRANSFE,,27-Jul-18,,1000000,2039366,,,
409000611074',Indfor INCOME INDO REMI27071,,30-Jul-18,2760,,2036606,ola,phonepe,wallet
409000611074',INDO GIBL Indiaforensic STL27071,,30-Jul-18,457875,,1578731,pentaloon,hdfc_bank,girl_friend
409000611074',Indfor INCOME INDO REMI28071,,30-Jul-18,600,,1578131,lenscart,mobikwik,bill_payments
409000611074',INDO GIBL Indiaforensic STL28071,,30-Jul-18,66800,,1511331,swiggy,zeppay,withdrawal
409000611074',Indfor INCOME INDO REMI30071,,31-Jul-18,2280,,1509051,uber,phonepe,withdrawal
409000611074',INDO GIBL Indiaforensic STL30071,,31-Jul-18,341400,,1167651,pentaloon,paytm,jewellary
409000611074',FDRL/INTERNAL FUND TRANSFE,,31-Jul-18,,300000,1467651,,,
409000611074',Indfor INCOME INDO REMI31071,,1-Aug-18,2760,,1464891,cred,amazon_pay,travel
409000611074',INDO GIBL Indiaforensic STL31071,,1-Aug-18,372350,,1092541,uber,bhim,girl_friend
409000611074',FDRL/INTERNAL FUND TRANSFE,,1-Aug-18,,300000,1392541,,,
409000611074',Indfor INCOME INDO REMI01081,,2-Aug-18,1080,,1391461,groffers,mobikwik,shopings
409000611074',INDO GIBL Indiaforensic STL01081,,2-Aug-18,145500,,1245961,bigboss,gpay,travel
409000611074',FDRL/INTERNAL FUND TRANSFE,,2-Aug-18,,300000,1545961,,,
409000611074',Indfor INCOME INDO REMI02081,,3-Aug-18,840,,1545121,zomato,hdfc_bank,girl_friend
409000611074',INDO GIBL Indiaforensic STL02081,,3-Aug-18,110550,,1434571,cred,amazon_pay,withdrawal
409000611074',Indfor INCOME INDO REMI03081,,4-Aug-18,1200,,1433371,pentaloon,phonepe,wallet
409000611074',INDO GIBL Indiaforensic STL03081,,4-Aug-18,220801,,1212570,ola,zeppay,jewellary
409000611074',Indfor INCOME INDO REMI04081,,6-Aug-18,1560,,1211010,cred,zeppay,girl_friend
409000611074',INDO GIBL Indiaforensic STL04081,,6-Aug-18,269850,,941160,mba_chai,amazon_pay,wallet
409000611074',Indfor INCOME INDO REMI05081,,6-Aug-18,240,,940920,ola,zeppay,bill_payments
409000611074',INDO GIBL Indiaforensic STL05081,,6-Aug-18,17500,,923420,zomato,zeppay,withdrawal
409000611074',FDRL/INTERNAL FUND TRANSFE,,7-Aug-18,,500000,1423420,,,
409000611074',Indfor INCOME INDO REMI06081,,7-Aug-18,3720,,1419700,bigboss,zeppay,withdrawal
409000611074',INDO GIBL Indiaforensic STL06081,,7-Aug-18,457050,,962650,zomato,hdfc_bank,shopings
409000611074',FDRL/INTERNAL FUND TRANSFE,,7-Aug-18,,300000,1262650,,,
409000611074',FDRL/INTERNAL FUND TRANSFE,,7-Aug-18,,300000,1562650,,,
409000611074',Indfor INCOME INDO REMI07081,,8-Aug-18,3840,,1558810,zomato,mobikwik,girl_friend
409000611074',INDO GIBL Indiaforensic STL07081,,8-Aug-18,662025,,896785,mba_chai,amazon_pay,travel
409000611074',FDRL/INTERNAL FUND TRANSFE,,8-Aug-18,,500000,1396785,,,
409000611074',Indfor INCOME INDO REMI08081,,9-Aug-18,3480,,1393305,bigboss,amazon_pay,girl_friend
409000611074',INDO GIBL Indiaforensic STL08081,,9-Aug-18,556450,,836855,uber,paytm,travel
409000611074',FDRL/INTERNAL FUND TRANSFE,,9-Aug-18,,500000,1336855,,,
409000611074',Indfor INCOME INDO REMI09081,,10-Aug-18,2280,,1334575,ola,paytm,shopings
409000611074',INDO GIBL Indiaforensic STL09081,,10-Aug-18,336850,,997725,bigboss,zeppay,shopings
409000611074',FDRL/INTERNAL FUND TRANSFE,,10-Aug-18,,1000000,1997725,,,
409000611074',Indfor INCOME INDO REMI10081,,13-Aug-18,2520,,1995205,cred,amazon_pay,wallet
409000611074',INDO GIBL Indiaforensic STL10081,,13-Aug-18,351200,,1644005,zomato,amazon_pay,girl_friend
409000611074',Indfor INCOME INDO REMI11081,,13-Aug-18,1320,,1642685,mba_chai,bhim,travel
409000611074',INDO GIBL Indiaforensic STL11081,,13-Aug-18,200700,,1441985,cred,bharatpe,wallet
409000611074',Indfor INCOME INDO REMI12081,,13-Aug-18,840,,1441145,lenscart,bharatpe,bill_payments
409000611074',INDO GIBL Indiaforensic STL12081,,13-Aug-18,116260,,1324885,zomato,zeppay,wallet
409000611074',Indfor INCOME INDO REMI13081,,14-Aug-18,3480,,1321405,pentaloon,paytm,grocery
409000611074',INDO GIBL Indiaforensic STL13081,,14-Aug-18,517655,,803750,mba_chai,amazon_pay,girl_friend
409000611074',FDRL/INTERNAL FUND TRANSFE,,14-Aug-18,,1000000,1803750,,,
409000611074',Indfor INCOME INDO REMI14081,,16-Aug-18,3600,,1800150,mba_chai,mobikwik,grocery
409000611074',INDO GIBL Indiaforensic STL14081,,16-Aug-18,561995,,1238155,pentaloon,paytm,bill_payments
409000611074',Indfor INCOME INDO REMI15081,,16-Aug-18,1320,,1236835,reliance,zeppay,grocery
409000611074',INDO GIBL Indiaforensic STL15081,,16-Aug-18,212000,,1024835,swiggy,amazon_pay,jewellary
409000611074',FDRL/INTERNAL FUND TRANSFE,,16-Aug-18,,500000,1524835,,,
409000611074',Indfor INCOME INDO REMI16081,,17-Aug-18,4440,,1520395,reliance,bharatpe,jewellary
409000611074',INDO GIBL Indiaforensic STL16081,,17-Aug-18,755505,,764890,uber,amazon_pay,wallet
409000611074',FDRL/INTERNAL FUND TRANSFE,,17-Aug-18,,400000,1164890,,,
409000611074',Indfor INCOME INDO REMI17081,,18-Aug-18,3960,,1160930,cred,phonepe,travel
409000611074',INDO GIBL Indiaforensic STL17081,,18-Aug-18,615328,,545602,zomato,bharatpe,travel
409000611074',FDRL/INTERNAL FUND TRANSFE,,18-Aug-18,,500000,1045602,,,
409000611074',FDRL/INTERNAL FUND TRANSFE,,18-Aug-18,,500000,1545602,,,
409000611074',Indfor INCOME INDO REMI18081,,20-Aug-18,1920,,1543682,bigboss,bharatpe,shopings
409000611074',INDO GIBL Indiaforensic STL18081,,20-Aug-18,262900,,1280782,mba_chai,bhim,shopings
409000611074',Indfor INCOME INDO REMI19081,,20-Aug-18,360,,1280422,cred,hdfc_bank,travel
409000611074',INDO GIBL Indiaforensic STL19081,,20-Aug-18,18000,,1262422,groffers,gpay,insurance
409000611074',FDRL/INTERNAL FUND TRANSFE,,21-Aug-18,,400000,1662422,,,
409000611074',Indfor INCOME INDO REMI20081,,21-Aug-18,4200,,1658222,uber,gpay,girl_friend
409000611074',INDO GIBL Indiaforensic STL20081,,21-Aug-18,554751,,1103471,reliance,phonepe,girl_friend
409000611074',FDRL/INTERNAL FUND TRANSFE,,23-Aug-18,,400000,1503471,,,
409000611074',FDRL/INTERNAL FUND TRANSFE,,23-Aug-18,,400000,1903471,,,
409000611074',Indfor INCOME INDO REMI21081,,23-Aug-18,5280,,1898191,swiggy,gpay,withdrawal
409000611074',INDO GIBL Indiaforensic STL21081,,23-Aug-18,912000,,986191,cred,amazon_pay,travel
409000611074',Indfor INCOME INDO REMI22081,,23-Aug-18,1800,,984391,mba_chai,paytm,bill_payments
409000611074',INDO GIBL Indiaforensic STL22081,,23-Aug-18,335601,,648790,groffers,paytm,travel
409000611074',FDRL/INTERNAL FUND TRANSFE,,23-Aug-18,,400000,1048790,,,
409000611074',Indfor INCOME INDO REMI23081,,24-Aug-18,2400,,1046390,lenscart,bhim,withdrawal
409000611074',INDO GIBL Indiaforensic STL23081,,24-Aug-18,338131,,708259,swiggy,hdfc_bank,travel
409000611074',FDRL/INTERNAL FUND TRANSFE,,24-Aug-18,,400000,1108259,,,
409000611074',FDRL/INTERNAL FUND TRANSFE,,24-Aug-18,,400000,1508259,,,
409000611074',Indfor INCOME INDO REMI24081,,27-Aug-18,1560,,1506699,lenscart,paytm,withdrawal
409000611074',INDO GIBL Indiaforensic STL24081,,27-Aug-18,230300,,1276399,uber,mobikwik,insurance
409000611074',Indfor INCOME INDO REMI25081,,27-Aug-18,720,,1275679,reliance,bhim,insurance
409000611074',INDO GIBL Indiaforensic STL25081,,27-Aug-18,71080,,1204599,groffers,amazon_pay,insurance
409000611074',FDRL/INTERNAL FUND TRANSFE,,27-Aug-18,,400000,1604599,,,
409000611074',Indfor INCOME INDO REMI27081,,28-Aug-18,4320,,1600279,uber,mobikwik,travel
409000611074',INDO GIBL Indiaforensic STL27081,,28-Aug-18,518401,,1081878,bigboss,gpay,withdrawal
409000611074',FDRL/INTERNAL FUND TRANSFE,,28-Aug-18,,400000,1481878,,,
409000611074',Indfor INCOME INDO REMI28081,,29-Aug-18,2160,,1479718,lenscart,mobikwik,shopings
409000611074',INDO GIBL Indiaforensic STL28081,,29-Aug-18,254584,,1225134,cred,zeppay,shopings
409000611074',FDRL/INTERNAL FUND TRANSFE,,29-Aug-18,,400000,1625134,,,
409000611074',Indfor INCOME INDO REMI29081,,30-Aug-18,2760,,1622374,lenscart,phonepe,wallet
409000611074',INDO GIBL Indiaforensic STL29081,,30-Aug-18,350585,,1271789,groffers,paytm,insurance
409000611074',Indfor INCOME INDO REMI30081,,31-Aug-18,2280,,1269509,bigboss,zeppay,withdrawal
409000611074',INDO GIBL Indiaforensic STL30081,,31-Aug-18,360425,,909084,reliance,mobikwik,bill_payments
409000611074',FDRL/INTERNAL FUND TRANSFE,,31-Aug-18,,500000,1409084,,,
409000611074',Indfor INCOME INDO REMI31081,,1-Sep-18,3000,,1406084,reliance,amazon_pay,girl_friend
409000611074',INDO WEIZ STL310818,,1-Sep-18,414101,,991983,zomato,zeppay,girl_friend
409000611074',FDRL/INTERNAL FUND TRANSFE,,1-Sep-18,,500000,1491983,,,
409000611074',Indfor INCOME INDO REMI01091,,3-Sep-18,1440,,1490543,reliance,zeppay,jewellary
409000611074',INDO GIBL Indiaforensic STL01091,,3-Sep-18,236300,,1254243,ola,bhim,insurance
409000611074',Indfor INCOME INDO REMI02091,,3-Sep-18,120,,1254123,reliance,hdfc_bank,shopings
409000611074',INDO GIBL Indiaforensic STL02091,,3-Sep-18,9800,,1244323,swiggy,bhim,withdrawal
409000611074',Indfor INCOME INDO REMI03091,,4-Sep-18,1920,,1242403,pentaloon,paytm,shopings
409000611074',INDO GIBL Indiaforensic STL03091,,4-Sep-18,228025,,1014378,pentaloon,zeppay,girl_friend
409000611074',FDRL/INTERNAL FUND TRANSFE,,4-Sep-18,,500000,1514378,,,
409000611074',Indfor INCOME INDO REMI04091,,5-Sep-18,2880,,1511498,zomato,paytm,bill_payments
409000611074',INDO WEIZ STL040918,,5-Sep-18,368300,,1143198,cred,mobikwik,bill_payments
409000611074',Indfor INCOME INDO REMI05091,,6-Sep-18,2880,,1140318,swiggy,paytm,insurance
409000611074',INDO GIBL Indiaforensic STL05091,,6-Sep-18,406628,,733690,zomato,gpay,shopings
409000611074',FDRL/INTERNAL FUND TRANSFE,,6-Sep-18,,500000,1233690,,,
409000611074',Indfor INCOME INDO REMI06091,,7-Sep-18,2760,,1230930,cred,zeppay,wallet
409000611074',INDO GIBL Indiaforensic STL06091,,7-Sep-18,377198,,853732,swiggy,mobikwik,travel
409000611074',FDRL/INTERNAL FUND TRANSFE,,10-Sep-18,,500000,1353732,,,
409000611074',Indfor INCOME INDO REMI07091,,10-Sep-18,3240,,1350492,lenscart,amazon_pay,grocery
409000611074',INDO GIBL Indiaforensic STL07091,,10-Sep-18,441750,,908742,pentaloon,hdfc_bank,withdrawal
409000611074',Indfor INCOME INDO REMI08091,,10-Sep-18,2040,,906702,uber,hdfc_bank,jewellary
409000611074',INDO GIBL Indiaforensic STL08091,,10-Sep-18,274751,,631951,mba_chai,gpay,travel
409000611074',Indfor INCOME INDO REMI09091,,10-Sep-18,360,,631591,ola,bhim,insurance
409000611074',INDO GIBL Indiaforensic STL09091,,10-Sep-18,61600,,569991,mba_chai,mobikwik,jewellary
409000611074',FDRL/INTERNAL FUND TRANSFE,,10-Sep-18,,500000,1069991,,,
409000611074',FDRL/INTERNAL FUND TRANSFE,,10-Sep-18,,500000,1569991,,,
409000611074',Indfor INCOME INDO REMI10091,,11-Sep-18,4200,,1565791,zomato,amazon_pay,jewellary
409000611074',INDO GIBL Indiaforensic STL10091,,11-Sep-18,537776,,1028015,zomato,amazon_pay,insurance
409000611074',FDRL/INTERNAL FUND TRANSFE,,12-Sep-18,,1000000,2028015,,,
409000611074',Indfor INCOME INDO REMI11091,,12-Sep-18,5160,,2022855,lenscart,bhim,shopings
409000611074',INDO GIBL Indiaforensic STL11091,,12-Sep-18,776577,,1246278,bigboss,zeppay,girl_friend
409000611074',Indfor INCOME INDO REMI12091,,14-Sep-18,1800,,1244478,cred,hdfc_bank,jewellary
409000611074',INDO GIBL Indiaforensic STL12091,,14-Sep-18,252025,,992453,uber,bharatpe,jewellary
409000611074',Indfor INCOME INDO REMI13091,,14-Sep-18,2520,,989933,mba_chai,bhim,grocery
409000611074',INDO GIBL Indiaforensic STL13091,,14-Sep-18,395501,,594432,reliance,paytm,jewellary
409000611074',FDRL/INTERNAL FUND TRANSFE,,14-Sep-18,,1000000,1594432,,,
409000611074',Indfor INCOME INDO REMI14091,,15-Sep-18,3720,,1590712,pentaloon,zeppay,bill_payments
409000611074',INDO GIBL Indiaforensic STL14091,,15-Sep-18,543351,,1047361,zomato,gpay,shopings
409000611074',FDRL/INTERNAL FUND TRANSFE,,17-Sep-18,,500000,1547361,,,
409000611074',FDRL/INTERNAL FUND TRANSFE,,17-Sep-18,,500000,2047361,,,
409000611074',Indfor INCOME INDO REMI15091,,17-Sep-18,1200,,2046161,swiggy,bharatpe,grocery
409000611074',INDO GIBL Indiaforensic STL15091,,17-Sep-18,223150,,1823011,cred,amazon_pay,shopings
409000611074',Indfor INCOME INDO REMI16091,,17-Sep-18,120,,1822891,pentaloon,mobikwik,wallet
409000611074',INDO GIBL Indiaforensic STL16091,,17-Sep-18,12500,,1810391,groffers,mobikwik,grocery
409000611074',Indfor INCOME INDO REMI17091,,18-Sep-18,3960,,1806431,reliance,amazon_pay,jewellary
409000611074',INDO GIBL Indiaforensic STL17091,,18-Sep-18,546674,,1259757,reliance,bharatpe,wallet
409000611074',Indfor INCOME INDO REMI18091,,19-Sep-18,3720,,1256037,zomato,mobikwik,grocery
409000611074',INDO GIBL Indiaforensic STL18091,,19-Sep-18,533052,,722985,pentaloon,phonepe,travel
409000611074',FDRL/INTERNAL FUND TRANSFE,,20-Sep-18,,500000,1222985,,,
409000611074',Indfor INCOME INDO REMI19091,,21-Sep-18,2640,,1220345,uber,bhim,insurance
409000611074',INDO GIBL Indiaforensic STL19091,,21-Sep-18,497477,,722868,reliance,bharatpe,shopings
409000611074',FDRL/INTERNAL FUND TRANSFE,,24-Sep-18,,500000,1222868,,,
409000611074',FDRL/INTERNAL FUND TRANSFE,,24-Sep-18,,500000,1722868,,,
409000611074',Indfor INCOME INDO REMI20091,,24-Sep-18,3120,,1719748,zomato,phonepe,shopings
409000611074',INDO GIBL Indiaforensic STL20091,,24-Sep-18,503006,,1216742,lenscart,mobikwik,bill_payments
409000611074',Indfor INCOME INDO REMI21091,,24-Sep-18,1800,,1214942,groffers,bharatpe,jewellary
409000611074',INDO GIBL Indiaforensic STL21091,,24-Sep-18,255052,,959890,pentaloon,hdfc_bank,bill_payments
409000611074',Indfor INCOME INDO REMI22091,,24-Sep-18,600,,959290,mba_chai,paytm,insurance
409000611074',INDO GIBL Indiaforensic STL22091,,24-Sep-18,78250,,881040,cred,mobikwik,girl_friend
409000611074',Indfor INCOME INDO REMI23091,,24-Sep-18,120,,880920,uber,amazon_pay,insurance
409000611074',INDO GIBL Indiaforensic STL23091,,24-Sep-18,6250,,874670,zomato,zeppay,withdrawal
409000611074',FDRL/INTERNAL FUND TRANSFE,,24-Sep-18,,500000,1374670,,,
409000611074',Indfor INCOME INDO REMI24091,,25-Sep-18,2280,,1372390,swiggy,paytm,bill_payments
409000611074',INDO GIBL Indiaforensic STL24091,,25-Sep-18,345725,,1026665,zomato,mobikwik,travel
409000611074',FDRL/INTERNAL FUND TRANSFE,,26-Sep-18,,500000,1526665,,,
409000611074',Indfor INCOME INDO REMI25091,,26-Sep-18,2520,,1524145,ola,gpay,insurance
409000611074',INDO GIBL Indiaforensic STL25091,,26-Sep-18,407252,,1116893,groffers,mobikwik,withdrawal
409000611074',Indfor INCOME INDO REMI26091,,27-Sep-18,1320,,1115573,cred,mobikwik,insurance
409000611074',INDO GIBL Indiaforensic STL26091,,27-Sep-18,256050,,859523,pentaloon,paytm,bill_payments
409000611074',FDRL/INTERNAL FUND TRANSFE,,28-Sep-18,,500000,1359523,,,
409000611074',Indfor INCOME INDO REMI27091,,28-Sep-18,2040,,1357483,lenscart,phonepe,jewellary
409000611074',INDO GIBL Indiaforensic STL27091,,28-Sep-18,327001,,1030482,bigboss,amazon_pay,insurance
409000611074',Indfor INCOME INDO REMI28091,,29-Sep-18,1920,,1028562,mba_chai,bharatpe,bill_payments
409000611074',INDO GIBL Indiaforensic STL28091,,29-Sep-18,231275,,797287,lenscart,mobikwik,grocery
409000611074',FDRL/INTERNAL FUND TRANSFE,,1-Oct-18,,500000,1297287,,,
409000611074',Indfor INCOME INDO REMI29091,,1-Oct-18,2040,,1295247,lenscart,paytm,travel
409000611074',INDO GIBL Indiaforensic STL29091,,1-Oct-18,333800,,961447,lenscart,bharatpe,withdrawal
409000611074',Indfor INCOME INDO REMI30091,,1-Oct-18,120,,961327,uber,zeppay,girl_friend
409000611074',INDO GIBL Indiaforensic STL30091,,1-Oct-18,5000,,956327,lenscart,bhim,jewellary
409000611074',FDRL/INTERNAL FUND TRANSFE,,3-Oct-18,,500000,1456327,,,
409000611074',Indfor INCOME INDO REMI01101,,3-Oct-18,3720,,1452607,reliance,hdfc_bank,shopings
409000611074',INDO GIBL Indiaforensic STL01101,,3-Oct-18,529105,,923502,pentaloon,phonepe,withdrawal
409000611074',Indfor INCOME INDO REMI02101,,3-Oct-18,1200,,922302,reliance,zeppay,shopings
409000611074',INDO GIBL Indiaforensic STL02101,,3-Oct-18,225300,,697002,reliance,hdfc_bank,jewellary
409000611074',FDRL/INTERNAL FUND TRANSFE,,3-Oct-18,,500000,1197002,,,
409000611074',FDRL/INTERNAL FUND TRANSFE,,3-Oct-18,,500000,1697002,,,
409000611074',Indfor INCOME INDO REMI03101,,4-Oct-18,3120,,1693882,mba_chai,gpay,girl_friend
409000611074',INDO GIBL Indiaforensic STL03101,,4-Oct-18,545402,,1148480,mba_chai,gpay,travel
409000611074',Indfor INCOME INDO REMI04101,,5-Oct-18,1440,,1147040,groffers,paytm,wallet
409000611074',INDO GIBL Indiaforensic STL04101,,5-Oct-18,156313,,990727,pentaloon,gpay,withdrawal
409000611074',Indfor INCOME INDO REMI05101,,6-Oct-18,1320,,989407,bigboss,bharatpe,insurance
409000611074',INDO GIBL Indiaforensic STL05101,,6-Oct-18,230751,,758656,ola,gpay,grocery
409000611074',FDRL/INTERNAL FUND TRANSFE,,6-Oct-18,,500000,1258656,,,
409000611074',Indfor INCOME INDO REMI07101,,8-Oct-18,480,,1258176,ola,paytm,jewellary
409000611074',INDO GIBL Indiaforensic STL07101,,8-Oct-18,56000,,1202176,pentaloon,amazon_pay,jewellary
409000611074',Indfor INCOME INDO REMI06101,,8-Oct-18,2280,,1199896,lenscart,amazon_pay,girl_friend
409000611074',INDO GIBL Indiaforensic STL06101,,8-Oct-18,282452,,917444,uber,zeppay,bill_payments
409000611074',FDRL/INTERNAL FUND TRANSFE,,8-Oct-18,,500000,1417444,,,
409000611074',Indfor INCOME INDO REMI08101,,9-Oct-18,4080,,1413364,pentaloon,zeppay,bill_payments
409000611074',INDO GIBL Indiaforensic STL08101,,9-Oct-18,530352,,883012,ola,bhim,grocery
409000611074',FDRL/INTERNAL FUND TRANSFE,,9-Oct-18,,500000,1383012,,,
409000611074',Indfor INCOME INDO REMI09101,,10-Oct-18,1920,,1381092,bigboss,bharatpe,girl_friend
409000611074',INDO GIBL Indiaforensic STL09101,,10-Oct-18,315083,,1066009,swiggy,gpay,girl_friend
409000611074',FDRL/INTERNAL FUND TRANSFE,,11-Oct-18,,500000,1566009,,,
409000611074',Indfor INCOME INDO REMI10101,,11-Oct-18,3720,,1562289,swiggy,gpay,travel
409000611074',INDO GIBL Indiaforensic STL10101,,11-Oct-18,584951,,977338,bigboss,zeppay,withdrawal
409000611074',FDRL/INTERNAL FUND TRANSFE,,12-Oct-18,,500000,1477338,,,
409000611074',Indfor INCOME INDO REMI11101,,12-Oct-18,4080,,1473258,uber,bhim,travel
409000611074',INDO GIBL Indiaforensic STL11101,,12-Oct-18,599251,,874007,lenscart,paytm,wallet
409000611074',FDRL/INTERNAL FUND TRANSFE,,15-Oct-18,,500000,1374007,,,
409000611074',FDRL/INTERNAL FUND TRANSFE,,15-Oct-18,,500000,1874007,,,
409000611074',Indfor INCOME INDO REMI12101,,15-Oct-18,3840,,1870167,mba_chai,hdfc_bank,wallet
409000611074',INDO GIBL Indiaforensic STL12101,,15-Oct-18,730425,,1139742,uber,amazon_pay,shopings
409000611074',Indfor INCOME INDO REMI13101,,15-Oct-18,1440,,1138302,uber,gpay,grocery
409000611074',INDO GIBL Indiaforensic STL13101,,15-Oct-18,173350,,964952,cred,amazon_pay,shopings
409000611074',Indfor INCOME INDO REMI14101,,15-Oct-18,360,,964592,swiggy,gpay,grocery
409000611074',INDO GIBL Indiaforensic STL14101,,15-Oct-18,34500,,930092,swiggy,mobikwik,jewellary
409000611074',FDRL/INTERNAL FUND TRANSFE,,16-Oct-18,,500000,1430092,,,
409000611074',Indfor INCOME INDO REMI15101,,16-Oct-18,5160,,1424932,mba_chai,hdfc_bank,jewellary
409000611074',INDO GIBL Indiaforensic STL15101,,16-Oct-18,780576,,644356,ola,bharatpe,bill_payments
409000611074',FDRL/INTERNAL FUND TRANSFE,,17-Oct-18,,200000,844356,,,
409000611074',FDRL/INTERNAL FUND TRANSFE,,17-Oct-18,,300000,1144356,,,
409000611074',FDRL/INTERNAL FUND TRANSFE,,17-Oct-18,,200000,1344356,,,
409000611074',FDRL/INTERNAL FUND TRANSFE,,17-Oct-18,,300000,1644356,,,
409000611074',Indfor INCOME INDO REMI16101,,17-Oct-18,4080,,1640276,reliance,hdfc_bank,withdrawal
409000611074',INDO GIBL Indiaforensic STL16101,,17-Oct-18,673628,,966648,zomato,amazon_pay,jewellary
409000611074',FDRL/INTERNAL FUND TRANSFE,,17-Oct-18,,500000,1466648,,,
409000611074',Indfor INCOME INDO REMI17101,,19-Oct-18,1200,,1465448,zomato,hdfc_bank,insurance
409000611074',INDO GIBL Indiaforensic STL17101,,19-Oct-18,119200,,1346248,ola,paytm,girl_friend
409000611074',Indfor INCOME INDO REMI18101,,19-Oct-18,1200,,1345048,mba_chai,mobikwik,bill_payments
409000611074',INDO GIBL Indiaforensic STL18101,,19-Oct-18,149802,,1195246,zomato,bharatpe,bill_payments
409000611074',Indfor INCOME INDO REMI19101,,20-Oct-18,480,,1194766,ola,gpay,withdrawal
409000611074',INDO GIBL Indiaforensic STL19101,,20-Oct-18,56000,,1138766,pentaloon,bharatpe,bill_payments
409000611074',Indfor INCOME INDO REMI20101,,22-Oct-18,1200,,1137566,ola,zeppay,insurance
409000611074',INDO GIBL Indiaforensic STL20101,,22-Oct-18,223600,,913966,pentaloon,phonepe,wallet
409000611074',Indfor INCOME INDO REMI21101,,22-Oct-18,120,,913846,zomato,mobikwik,shopings
409000611074',INDO GIBL Indiaforensic STL21101,,22-Oct-18,10500,,903346,pentaloon,phonepe,girl_friend
409000611074',FDRL/INTERNAL FUND TRANSFE,,22-Oct-18,,500000,1403346,,,
409000611074',Indfor INCOME INDO REMI22101,,23-Oct-18,2760,,1400586,bigboss,amazon_pay,travel
409000611074',INDO GIBL Indiaforensic STL22101,,23-Oct-18,436678,,963908,zomato,bharatpe,bill_payments
409000611074',FDRL/INTERNAL FUND TRANSFE,,23-Oct-18,,200000,1163908,,,
409000611074',Indfor INCOME INDO REMI23101,,24-Oct-18,2040,,1161868,swiggy,gpay,jewellary
409000611074',INDO GIBL Indiaforensic STL23101,,24-Oct-18,432150,,729718,ola,bharatpe,wallet
409000611074',FDRL/INTERNAL FUND TRANSFE,,24-Oct-18,,500000,1229718,,,
409000611074',Indfor INCOME INDO REMI24101,,25-Oct-18,1320,,1228398,groffers,bharatpe,bill_payments
409000611074',INDO GIBL Indiaforensic STL24101,,25-Oct-18,156401,,1071997,ola,zeppay,girl_friend
409000611074',Indfor INCOME INDO REMI25101,,26-Oct-18,1320,,1070677,bigboss,bharatpe,grocery
409000611074',INDO GIBL Indiaforensic STL25101,,26-Oct-18,232683,,837994,pentaloon,hdfc_bank,bill_payments
409000611074',FDRL/INTERNAL FUND TRANSFE,,29-Oct-18,,200000,1037994,,,
409000611074',FDRL/INTERNAL FUND TRANSFE,,29-Oct-18,,200000,1237994,,,
409000611074',FDRL/INTERNAL FUND TRANSFE,,29-Oct-18,,200000,1437994,,,
409000611074',Indfor INCOME INDO REMI26101,,29-Oct-18,1560,,1436434,bigboss,hdfc_bank,jewellary
409000611074',INDO GIBL Indiaforensic STL26101,,29-Oct-18,224800,,1211634,cred,gpay,shopings
409000611074',Indfor INCOME INDO REMI27101,,29-Oct-18,1200,,1210434,bigboss,phonepe,grocery
409000611074',INDO GIBL Indiaforensic STL27101,,29-Oct-18,254250,,956184,bigboss,bhim,girl_friend
409000611074',Indfor INCOME INDO REMI29101,,30-Oct-18,3360,,952824,mba_chai,phonepe,insurance
409000611074',INDO GIBL Indiaforensic STL29101,,30-Oct-18,364175,,588649,cred,bhim,grocery
409000611074',FDRL/INTERNAL FUND TRANSFE,,30-Oct-18,,200000,788649,,,
409000611074',FDRL/INTERNAL FUND TRANSFE,,30-Oct-18,,300000,1088649,,,
409000611074',Indfor INCOME INDO REMI30101,,31-Oct-18,2520,,1086129,reliance,bhim,grocery
409000611074',INDO GIBL Indiaforensic STL30101,,31-Oct-18,274602,,811527,ola,amazon_pay,jewellary
409000611074',FDRL/INTERNAL FUND TRANSFE,,31-Oct-18,,200000,1011527,,,
409000611074',FDRL/INTERNAL FUND TRANSFE,,31-Oct-18,,300000,1311527,,,
409000611074',Indfor INCOME INDO REMI31101,,1-Nov-18,1920,,1309607,mba_chai,phonepe,wallet
409000611074',INDO GIBL Indiaforensic STL31101,,1-Nov-18,239305,,1070302,ola,hdfc_bank,shopings
409000611074',Indfor INCOME INDO REMI01111,,2-Nov-18,1680,,1068622,ola,hdfc_bank,insurance
409000611074',INDO GIBL Indiaforensic STL01111,,2-Nov-18,192675,,875947,zomato,gpay,travel
409000611074',Indfor INCOME INDO REMI02111,,3-Nov-18,2640,,873307,reliance,bharatpe,insurance
409000611074',INDO GIBL Indiaforensic STL02111,,3-Nov-18,369251,,504056,lenscart,zeppay,travel
409000611074',FDRL/INTERNAL FUND TRANSFE,,3-Nov-18,,500000,1004056,,,
409000611074',Indfor INCOME INDO REMI03111,,5-Nov-18,2280,,1001776,zomato,paytm,girl_friend
409000611074',INDO GIBL Indiaforensic STL03111,,5-Nov-18,323726,,678050,mba_chai,bhim,wallet
409000611074',Indfor INCOME INDO REMI04111,,5-Nov-18,840,,677210,lenscart,zeppay,grocery
409000611074',INDO GIBL Indiaforensic STL04111,,5-Nov-18,129000,,548210,uber,mobikwik,insurance
409000611074',FDRL/INTERNAL FUND TRANSFE,,5-Nov-18,,500000,1048210,,,
409000611074',FDRL/INTERNAL FUND TRANSFE,,6-Nov-18,,500000,1548210,,,
409000611074',Indfor INCOME INDO REMI05111,,6-Nov-18,4920,,1543290,reliance,gpay,girl_friend
409000611074',INDO GIBL Indiaforensic STL05111,,6-Nov-18,807502,,735788,reliance,mobikwik,wallet
409000611074',FDRL/INTERNAL FUND TRANSFE,,6-Nov-18,,500000,1235788,,,
409000611074',FDRL/INTERNAL FUND TRANSFE,,8-Nov-18,,500000,1735788,,,
409000611074',Indfor INCOME INDO REMI06111,,9-Nov-18,4920,,1730868,swiggy,hdfc_bank,insurance
409000611074',INDO GIBL Indiaforensic STL06111,,9-Nov-18,780026,,950842,groffers,zeppay,withdrawal
409000611074',Indfor INCOME INDO REMI07111,,9-Nov-18,1320,,949522,mba_chai,amazon_pay,insurance
409000611074',INDO GIBL Indiaforensic STL07111,,9-Nov-18,153513,,796009,pentaloon,mobikwik,jewellary
409000611074',Indfor INCOME INDO REMI08111,,9-Nov-18,600,,795409,pentaloon,amazon_pay,withdrawal
409000611074',INDO GIBL Indiaforensic STL08111,,9-Nov-18,102725,,692684,swiggy,bharatpe,jewellary
409000611074',FDRL/INTERNAL FUND TRANSFE,,9-Nov-18,,500000,1192684,,,
409000611074',FDRL/INTERNAL FUND TRANSFE,,12-Nov-18,,200000,1392684,,,
409000611074',FDRL/INTERNAL FUND TRANSFE,,12-Nov-18,,200000,1592684,,,
409000611074',Indfor INCOME INDO REMI09111,,12-Nov-18,2040,,1590644,uber,hdfc_bank,wallet
409000611074',INDO GIBL Indiaforensic STL09111,,12-Nov-18,478599,,1112045,bigboss,paytm,jewellary
409000611074',Indfor INCOME INDO REMI11111,,12-Nov-18,120,,1111925,groffers,mobikwik,withdrawal
409000611074',INDO GIBL Indiaforensic STL11111,,12-Nov-18,8000,,1103925,pentaloon,amazon_pay,bill_payments
409000611074',Indfor INCOME INDO REMI10111,,12-Nov-18,2040,,1101885,bigboss,bharatpe,shopings
409000611074',INDO GIBL Indiaforensic STL10111,,12-Nov-18,284926,,816959,swiggy,zeppay,jewellary
409000611074',FDRL/INTERNAL FUND TRANSFE,,12-Nov-18,,200000,1016959,,,
409000611074',Indfor INCOME INDO REMI12111,,13-Nov-18,2280,,1014679,zomato,mobikwik,bill_payments
409000611074',INDO GIBL Indiaforensic STL12111,,13-Nov-18,354000,,660679,lenscart,zeppay,bill_payments
409000611074',FDRL/INTERNAL FUND TRANSFE,,13-Nov-18,,200000,860679,,,
409000611074',FDRL/INTERNAL FUND TRANSFE,,13-Nov-18,,300000,1160679,,,
409000611074',FDRL/INTERNAL FUND TRANSFE,,14-Nov-18,,300000,1460679,,,
409000611074',FDRL/INTERNAL FUND TRANSFE,,14-Nov-18,,200000,1660679,,,
409000611074',Indfor INCOME INDO REMI13111,,14-Nov-18,4080,,1656599,ola,paytm,insurance
409000611074',INDO GIBL Indiaforensic STL13111,,14-Nov-18,800876,,855723,swiggy,mobikwik,travel
409000611074',FDRL/INTERNAL FUND TRANSFE,,15-Nov-18,,300000,1155723,,,
409000611074',Indfor INCOME INDO REMI14111,,15-Nov-18,2160,,1153563,uber,bhim,grocery
409000611074',INDO GIBL Indiaforensic STL14111,,15-Nov-18,404700,,748863,swiggy,bhim,wallet
409000611074',FDRL/INTERNAL FUND TRANSFE,,15-Nov-18,,300000,1048863,,,
409000611074',Indfor INCOME INDO REMI15111,,16-Nov-18,3000,,1045863,ola,hdfc_bank,bill_payments
409000611074',INDO GIBL Indiaforensic STL15111,,16-Nov-18,580226,,465637,pentaloon,bhim,girl_friend
409000611074',FDRL/INTERNAL FUND TRANSFE,,16-Nov-18,,500000,965637,,,
409000611074',FDRL/INTERNAL FUND TRANSFE,,17-Nov-18,,300000,1265637,,,
409000611074',Indfor INCOME INDO REMI16111,,17-Nov-18,3000,,1262637,swiggy,bhim,girl_friend
409000611074',INDO GIBL Indiaforensic STL16111,,17-Nov-18,583076,,679561,ola,hdfc_bank,withdrawal
409000611074',FDRL/INTERNAL FUND TRANSFE,,17-Nov-18,,400000,1079561,,,
409000611074',FDRL/INTERNAL FUND TRANSFE,,17-Nov-18,,400000,1479561,,,
409000611074',Indfor INCOME INDO REMI18111,,19-Nov-18,360,,1479201,groffers,amazon_pay,withdrawal
409000611074',INDO GIBL Indiaforensic STL18111,,19-Nov-18,59700,,1419501,swiggy,bharatpe,shopings
409000611074',Indfor INCOME INDO REMI17111,,19-Nov-18,1320,,1418181,swiggy,zeppay,withdrawal
409000611074',INDO GIBL Indiaforensic STL17111,,19-Nov-18,207463,,1210718,swiggy,zeppay,withdrawal
409000611074',FDRL/INTERNAL FUND TRANSFE,,20-Nov-18,,300000,1510718,,,
409000611074',Indfor INCOME INDO REMI19111,,20-Nov-18,3600,,1507118,swiggy,paytm,withdrawal
409000611074',INDO GIBL Indiaforensic STL19111,,20-Nov-18,613175,,893943,swiggy,hdfc_bank,jewellary
409000611074',FDRL/INTERNAL FUND TRANSFE,,20-Nov-18,,400000,1293943,,,
409000611074',FDRL/INTERNAL FUND TRANSFE,,22-Nov-18,,400000,1693943,,,
409000611074',Indfor INCOME INDO REMI20111,,22-Nov-18,3960,,1689983,swiggy,phonepe,jewellary
409000611074',INDO GIBL Indiaforensic STL20111,,22-Nov-18,628403,,1061580,pentaloon,hdfc_bank,jewellary
409000611074',Indfor INCOME INDO REMI21111,,22-Nov-18,1800,,1059780,swiggy,mobikwik,jewellary
409000611074',INDO GIBL Indiaforensic STL21111,,22-Nov-18,250951,,808829,lenscart,gpay,grocery
409000611074',FDRL/INTERNAL FUND TRANSFE,,22-Nov-18,,300000,1108829,,,
409000611074',FDRL/INTERNAL FUND TRANSFE,,22-Nov-18,,300000,1408829,,,
409000611074',FDRL/INTERNAL FUND TRANSFE,,23-Nov-18,,400000,1808829,,,
409000611074',Indfor INCOME INDO REMI25111,,26-Nov-18,480,,1808349,mba_chai,bhim,shopings
409000611074',INDO GIBL Indiaforensic STL25111,,26-Nov-18,63600,,1744749,zomato,phonepe,jewellary
409000611074',Indfor INCOME INDO REMI24111,,26-Nov-18,360,,1744389,ola,bhim,withdrawal
409000611074',INDO GIBL Indiaforensic STL24111,,26-Nov-18,49700,,1694689,reliance,paytm,insurance
409000611074',Indfor INCOME INDO REMI23111,,26-Nov-18,1560,,1693129,pentaloon,bharatpe,withdrawal
409000611074',INDO GIBL Indiaforensic STL23111,,26-Nov-18,220402,,1472727,lenscart,hdfc_bank,shopings
409000611074',Indfor INCOME INDO REMI22111,,26-Nov-18,2280,,1470447,mba_chai,phonepe,grocery
409000611074',INDO GIBL Indiaforensic STL22111,,26-Nov-18,334100,,1136347,pentaloon,bharatpe,bill_payments
409000611074',FDRL/INTERNAL FUND TRANSFE,,26-Nov-18,,400000,1536347,,,
409000611074',Indfor INCOME INDO REMI26111,,27-Nov-18,4440,,1531907,reliance,phonepe,wallet
409000611074',INDO GIBL Indiaforensic STL26111,,27-Nov-18,615817,,916090,pentaloon,paytm,insurance
409000611074',FDRL/INTERNAL FUND TRANSFE,,27-Nov-18,,300000,1216090,,,
409000611074',FDRL/INTERNAL FUND TRANSFE,,27-Nov-18,,400000,1616090,,,
409000611074',Indfor INCOME INDO REMI27111,,28-Nov-18,2760,,1613330,uber,bharatpe,bill_payments
409000611074',INDO GIBL Indiaforensic STL27111,,28-Nov-18,508126,,1105204,ola,gpay,withdrawal
409000611074',FDRL/INTERNAL FUND TRANSFE,,28-Nov-18,,400000,1505204,,,
409000611074',Indfor INCOME INDO REMI28111,,29-Nov-18,2160,,1503044,zomato,amazon_pay,insurance
409000611074',INDO GIBL Indiaforensic STL28111,,29-Nov-18,326783,,1176261,bigboss,phonepe,travel
409000611074',Indfor INCOME INDO REMI29111,,30-Nov-18,1800,,1174461,mba_chai,hdfc_bank,withdrawal
409000611074',INDO GIBL Indiaforensic STL29111,,30-Nov-18,247700,,926761,ola,paytm,withdrawal
409000611074',FDRL/INTERNAL FUND TRANSFE,,30-Nov-18,,400000,1326761,,,
409000611074',Indfor INCOME INDO REMI30111,,1-Dec-18,3360,,1323401,swiggy,mobikwik,shopings
409000611074',INDO GIBL Indiaforensic STL30111,,1-Dec-18,510703,,812698,reliance,gpay,girl_friend
409000611074',FDRL/INTERNAL FUND TRANSFE,,1-Dec-18,,400000,1212698,,,
409000611074',Indfor INCOME INDO REMI02121,,3-Dec-18,120,,1212578,ola,paytm,withdrawal
409000611074',INDO GIBL Indiaforensic STL02121,,3-Dec-18,5000,,1207578,pentaloon,gpay,withdrawal
409000611074',Indfor INCOME INDO REMI01121,,3-Dec-18,840,,1206738,swiggy,zeppay,girl_friend
409000611074',INDO GIBL Indiaforensic STL01121,,3-Dec-18,135500,,1071238,uber,phonepe,grocery
409000611074',FDRL/INTERNAL FUND TRANSFE,,3-Dec-18,,500000,1571238,,,
409000611074',Indfor INCOME INDO REMI03121,,4-Dec-18,1560,,1569678,lenscart,bhim,girl_friend
409000611074',INDO GIBL Indiaforensic STL03121,,4-Dec-18,244750,,1324928,pentaloon,paytm,withdrawal
409000611074',Indfor INCOME INDO REMI04121,,5-Dec-18,1920,,1323008,cred,paytm,grocery
409000611074',INDO GIBL Indiaforensic STL04121,,5-Dec-18,233851,,1089157,ola,paytm,jewellary
409000611074',FDRL/INTERNAL FUND TRANSFE,,6-Dec-18,,500000,1589157,,,
409000611074',Indfor INCOME INDO REMI05121,,6-Dec-18,2760,,1586397,swiggy,amazon_pay,travel
409000611074',INDO GIBL Indiaforensic STL05121,,6-Dec-18,437150,,1149247,mba_chai,hdfc_bank,insurance
409000611074',Indfor INCOME INDO REMI06121,,7-Dec-18,2640,,1146607,lenscart,mobikwik,bill_payments
409000611074',INDO GIBL Indiaforensic STL06121,,7-Dec-18,397925,,748682,bigboss,paytm,travel
409000611074',FDRL/INTERNAL FUND TRANSFE,,7-Dec-18,,500000,1248682,,,
409000611074',FDRL/INTERNAL FUND TRANSFE,,7-Dec-18,,500000,1748682,,,
409000611074',Indfor INCOME INDO REMI07121,,10-Dec-18,1680,,1747002,zomato,mobikwik,travel
409000611074',INDO GIBL Indiaforensic STL07121,,10-Dec-18,228177,,1518825,ola,bhim,grocery
409000611074',Indfor INCOME INDO REMI08121,,10-Dec-18,2160,,1516665,reliance,gpay,withdrawal
409000611074',INDO GIBL Indiaforensic STL08121,,10-Dec-18,240752,,1275913,groffers,amazon_pay,wallet
409000611074',Indfor INCOME INDO REMI09121,,10-Dec-18,360,,1275553,zomato,bhim,grocery
409000611074',INDO GIBL Indiaforensic STL09121,,10-Dec-18,48000,,1227553,mba_chai,bharatpe,withdrawal
409000611074',FDRL/INTERNAL FUND TRANSFE,,11-Dec-18,,500000,1727553,,,
409000611074',Indfor INCOME INDO REMI10121,,11-Dec-18,4560,,1722993,pentaloon,mobikwik,wallet
409000611074',INDO GIBL Indiaforensic STL10121,,11-Dec-18,776851,,946142,zomato,mobikwik,travel
409000611074',FDRL/INTERNAL FUND TRANSFE,,12-Dec-18,,500000,1446142,,,
409000611074',Indfor INCOME INDO REMI11121,,12-Dec-18,3360,,1442782,reliance,paytm,wallet
409000611074',INDO GIBL Indiaforensic STL11121,,12-Dec-18,358750,,1084032,ola,bharatpe,insurance
409000611074',FDRL/INTERNAL FUND TRANSFE,,12-Dec-18,,500000,1584032,,,
409000611074',Indfor INCOME INDO REMI12121,,13-Dec-18,3360,,1580672,reliance,zeppay,grocery
409000611074',INDO GIBL Indiaforensic STL12121,,13-Dec-18,596375,,984297,ola,mobikwik,girl_friend
409000611074',FDRL/INTERNAL FUND TRANSFE,,13-Dec-18,,500000,1484297,,,
409000611074',Indfor INCOME INDO REMI13121,,14-Dec-18,2880,,1481417,lenscart,phonepe,shopings
409000611074',INDO GIBL Indiaforensic STL13121,,14-Dec-18,419450,,1061967,reliance,gpay,wallet
409000611074',FDRL/INTERNAL FUND TRANSFE,,14-Dec-18,,500000,1561967,,,
409000611074',Indfor INCOME INDO REMI14121,,15-Dec-18,2400,,1559567,cred,zeppay,travel
409000611074',INDO GIBL Indiaforensic STL14121,,15-Dec-18,423385,,1136182,groffers,gpay,insurance
409000611074',FDRL/INTERNAL FUND TRANSFE,,17-Dec-18,,400000,1536182,,,
409000611074',FDRL/INTERNAL FUND TRANSFE,,17-Dec-18,,400000,1936182,,,
409000611074',Indfor INCOME INDO REMI16121,,17-Dec-18,360,,1935822,reliance,hdfc_bank,insurance
409000611074',INDO GIBL Indiaforensic STL16121,,17-Dec-18,33549,,1902273,zomato,mobikwik,withdrawal
409000611074',Indfor INCOME INDO REMI15121,,17-Dec-18,1680,,1900593,ola,zeppay,insurance
409000611074',INDO GIBL Indiaforensic STL15121,,17-Dec-18,288851,,1611742,reliance,bharatpe,shopings
409000611074',Indfor INCOME INDO REMI17121,,18-Dec-18,4440,,1607302,uber,hdfc_bank,wallet
409000611074',INDO GIBL Indiaforensic STL17121,,18-Dec-18,662777,,944525,zomato,phonepe,grocery
409000611074',FDRL/INTERNAL FUND TRANSFE,,18-Dec-18,,500000,1444525,,,
409000611074',Indfor INCOME INDO REMI18121,,19-Dec-18,3480,,1441045,zomato,gpay,travel
409000611074',INDO GIBL Indiaforensic STL18121,,19-Dec-18,616950,,824095,uber,mobikwik,wallet
409000611074',FDRL/INTERNAL FUND TRANSFE,,19-Dec-18,,400000,1224095,,,
409000611074',Indfor INCOME INDO REMI19121,,20-Dec-18,3120,,1220975,cred,bhim,shopings
409000611074',INDO GIBL Indiaforensic STL19121,,20-Dec-18,428150,,792825,uber,paytm,insurance
409000611074',FDRL/INTERNAL FUND TRANSFE,,20-Dec-18,,500000,1292825,,,
409000611074',Indfor INCOME INDO REMI20121,,21-Dec-18,2640,,1290185,pentaloon,phonepe,bill_payments
409000611074',INDO GIBL Indiaforensic STL20121,,21-Dec-18,425752,,864433,ola,mobikwik,travel
409000611074',FDRL/INTERNAL FUND TRANSFE,,21-Dec-18,,500000,1364433,,,
409000611074',Indfor INCOME INDO REMI23121,,24-Dec-18,120,,1364313,zomato,gpay,girl_friend
409000611074',INDO GIBL Indiaforensic STL23121,,24-Dec-18,20000,,1344313,swiggy,phonepe,wallet
409000611074',Indfor INCOME INDO REMI22121,,24-Dec-18,960,,1343353,uber,bhim,withdrawal
409000611074',INDO GIBL Indiaforensic STL22121,,24-Dec-18,130600,,1212753,uber,bharatpe,girl_friend
409000611074',Indfor INCOME INDO REMI21121,,24-Dec-18,2760,,1209993,swiggy,bharatpe,wallet
409000611074',INDO GIBL Indiaforensic STL21121,,24-Dec-18,422577,,787416,lenscart,bharatpe,bill_payments
409000611074',FDRL/INTERNAL FUND TRANSFE,,24-Dec-18,,500000,1287416,,,
409000611074',FDRL/INTERNAL FUND TRANSFE,,24-Dec-18,,400000,1687416,,,
409000611074',Indfor INCOME INDO REMI25121,,26-Dec-18,1320,,1686096,cred,paytm,grocery
409000611074',INDO GIBL Indiaforensic STL25121,,26-Dec-18,173441,,1512655,uber,bharatpe,wallet
409000611074',Indfor INCOME INDO REMI24121,,26-Dec-18,4680,,1507975,groffers,gpay,grocery
409000611074',INDO GIBL Indiaforensic STL24121,,26-Dec-18,692917,,815058,lenscart,gpay,girl_friend
409000611074',FDRL/INTERNAL FUND TRANSFE,,26-Dec-18,,500000,1315058,,,
409000611074',Indfor INCOME INDO REMI26121,,27-Dec-18,1320,,1313738,lenscart,bharatpe,travel
409000611074',INDO GIBL Indiaforensic STL26121,,27-Dec-18,250849,,1062889,zomato,gpay,shopings
409000611074',FDRL/INTERNAL FUND TRANSFE,,27-Dec-18,,500000,1562889,,,
409000611074',Indfor INCOME INDO REMI27121,,28-Dec-18,4080,,1558809,ola,phonepe,girl_friend
409000611074',INDO GIBL Indiaforensic STL27121,,28-Dec-18,625478,,933331,cred,bharatpe,bill_payments
409000611074',FDRL/INTERNAL FUND TRANSFE,,28-Dec-18,,400000,1333331,,,
409000611074',Indfor INCOME INDO REMI28121,,29-Dec-18,1320,,1332011,lenscart,bharatpe,bill_payments
409000611074',INDO GIBL Indiaforensic STL28121,,29-Dec-18,153500,,1178511,groffers,bhim,wallet
409000611074',FDRL/INTERNAL FUND TRANSFE,,29-Dec-18,,400000,1578511,,,
409000611074',Indfor INCOME INDO REMI30121,,31-Dec-18,240,,1578271,bigboss,paytm,grocery
409000611074',INDO GIBL Indiaforensic STL30121,,31-Dec-18,68700,,1509571,mba_chai,amazon_pay,grocery
409000611074',Indfor INCOME INDO REMI29121,,31-Dec-18,1200,,1508371,cred,zeppay,shopings
409000611074',INDO GIBL Indiaforensic STL29121,,31-Dec-18,200550,,1307821,reliance,bharatpe,girl_friend
409000611074',FDRL/INTERNAL FUND TRANSFE,,31-Dec-18,,400000,1707821,,,
